serial:no,age,gender,year_in_school,major,monthly_income,tuition,financial_aid,housing,food,transportation,books_supplies,entertainment,personal_care,technology,health_wellness,expense,savings,preferred_payment_method
0,19,Non-binary,Freshman,Psychology,5939,958,270,709,296,123,188,41,78,134,127,2924,3015,Credit/Debit Card
1,24,Female,Junior,Economics,4908,1006,875,557,365,85,252,74,92,226,129,3661,1247,Credit/Debit Card
2,24,Non-binary,Junior,Economics,3051,734,928,666,220,137,99,130,23,239,112,3288,-237,Cash
3,23,Female,Senior,Computer Science,4935,617,265,652,289,114,223,99,30,163,105,2557,2378,Mobile Payment App
4,20,Female,Senior,Computer Science,3887,810,522,825,372,168,194,48,71,88,71,3169,718,Credit/Debit Card
5,25,Non-binary,Sophomore,Computer Science,3151,523,790,413,386,122,131,73,38,234,108,2818,333,Mobile Payment App
6,23,Female,Freshman,Engineering,4973,1354,69,812,398,101,213,21,38,157,117,3280,1693,Credit/Debit Card
7,23,Female,Junior,Economics,3966,631,748,571,269,92,251,37,90,152,56,2897,1069,Mobile Payment App
8,22,Non-binary,Senior,Computer Science,5638,1402,248,599,354,82,155,123,41,162,172,3338,2300,Credit/Debit Card
9,18,Female,Junior,Computer Science,3977,1423,74,626,249,117,123,51,74,243,34,3014,963,Mobile Payment App
10,23,Male,Junior,Biology,4093,762,615,660,262,58,183,98,21,274,66,2999,1094,Credit/Debit Card
11,25,Male,Freshman,Engineering,5138,1068,19,734,243,200,228,57,57,209,193,3008,2130,Credit/Debit Card
12,21,Male,Sophomore,Economics,4863,719,540,894,280,120,126,41,50,78,113,2961,1902,Credit/Debit Card
13,19,Female,Junior,Biology,5201,1176,859,626,234,50,274,20,77,125,199,3640,1561,Mobile Payment App
14,24,Non-binary,Freshman,Economics,5301,1496,75,657,151,63,92,124,64,196,50,2968,2333,Cash
15,22,Non-binary,Sophomore,Computer Science,4175,1227,26,884,328,167,175,111,96,73,154,3241,934,Cash
16,23,Female,Freshman,Psychology,5450,1419,237,883,361,200,141,76,22,285,185,3809,1641,Cash
17,21,Female,Freshman,Computer Science,3538,1454,851,754,357,110,188,33,24,50,74,3895,-357,Mobile Payment App
18,19,Female,Sophomore,Psychology,4401,1487,311,883,292,69,51,75,60,105,181,3514,887,Credit/Debit Card
19,20,Female,Senior,Engineering,3131,1157,401,886,196,131,216,57,39,264,39,3386,-255,Mobile Payment App
20,19,Male,Junior,Psychology,4206,1180,732,597,254,195,67,51,21,97,185,3379,827,Credit/Debit Card
21,24,Male,Sophomore,Computer Science,4878,516,549,814,286,180,282,55,25,77,73,2857,2021,Mobile Payment App
22,18,Non-binary,Sophomore,Biology,4998,1225,610,473,159,134,294,37,86,159,60,3237,1761,Cash
23,24,Non-binary,Senior,Economics,4210,582,285,421,348,138,143,62,85,218,113,2395,1815,Credit/Debit Card
24,19,Female,Senior,Economics,4500,1062,56,731,238,103,76,111,95,238,74,2784,1716,Mobile Payment App
25,25,Female,Junior,Biology,5486,1054,528,789,400,81,211,95,74,237,140,3609,1877,Mobile Payment App
26,20,Male,Senior,Economics,3541,667,690,762,173,185,288,53,38,84,159,3099,442,Credit/Debit Card
27,20,Female,Junior,Psychology,5616,796,705,664,291,179,260,127,21,113,194,3350,2266,Credit/Debit Card
28,24,Non-binary,Sophomore,Psychology,4156,905,671,444,163,131,141,132,31,156,95,2869,1287,Credit/Debit Card
29,23,Non-binary,Junior,Engineering,3099,531,448,742,394,179,95,64,62,73,104,2692,407,Mobile Payment App
30,23,Non-binary,Freshman,Economics,5943,1426,3,677,296,110,137,146,21,155,105,3076,2867,Mobile Payment App
31,23,Male,Sophomore,Psychology,5417,1465,302,468,113,190,134,119,82,276,165,3314,2103,Mobile Payment App
32,24,Non-binary,Junior,Computer Science,5236,522,555,860,169,133,147,123,48,138,89,2784,2452,Credit/Debit Card
33,25,Female,Freshman,Economics,5615,1338,110,468,325,158,244,98,46,231,183,3201,2414,Cash
34,23,Male,Junior,Biology,3222,1363,365,695,185,166,99,116,68,77,31,3165,57,Mobile Payment App
35,21,Male,Freshman,Biology,3090,1328,320,718,254,93,204,74,30,228,60,3309,-219,Cash
36,22,Male,Sophomore,Engineering,3931,1350,675,462,372,147,282,149,92,269,105,3903,28,Cash
37,23,Non-binary,Senior,Computer Science,5160,1309,265,600,178,148,186,88,78,242,54,3148,2012,Cash
38,21,Female,Senior,Biology,5344,965,251,695,249,88,249,49,29,298,96,2969,2375,Cash
39,20,Female,Senior,Engineering,5733,600,392,791,309,178,67,22,29,142,74,2604,3129,Mobile Payment App
40,24,Female,Freshman,Engineering,5696,605,118,653,165,189,151,86,82,117,83,2249,3447,Mobile Payment App
41,25,Male,Sophomore,Economics,5332,804,140,517,289,147,153,125,43,159,44,2421,2911,Cash
42,23,Female,Sophomore,Economics,4639,1274,449,755,137,55,249,103,50,176,67,3315,1324,Cash
43,23,Male,Junior,Psychology,3958,509,942,511,391,192,264,57,85,108,115,3174,784,Credit/Debit Card
44,23,Female,Senior,Economics,3823,1285,881,740,253,182,230,32,92,118,34,3847,-24,Credit/Debit Card
45,18,Male,Freshman,Computer Science,3854,929,348,590,204,196,183,129,80,163,116,2938,916,Credit/Debit Card
46,25,Non-binary,Freshman,Psychology,4951,1163,235,549,261,86,185,102,21,252,31,2885,2066,Cash
47,19,Male,Senior,Psychology,5269,1195,745,920,167,57,88,113,60,242,35,3622,1647,Mobile Payment App
48,25,Male,Junior,Psychology,4141,1036,260,918,122,86,105,62,88,90,169,2936,1205,Cash
49,24,Female,Junior,Economics,4875,588,211,604,163,101,198,89,23,128,62,2167,2708,Mobile Payment App
50,20,Female,Junior,Engineering,5414,1377,723,786,355,137,187,45,90,145,200,4045,1369,Cash
51,21,Non-binary,Freshman,Economics,5481,1451,479,661,140,67,128,31,48,293,37,3335,2146,Credit/Debit Card
52,19,Male,Senior,Computer Science,3823,669,660,837,193,115,75,121,65,150,96,2981,842,Cash
53,18,Male,Freshman,Psychology,4079,1294,818,806,115,97,71,24,31,79,107,3442,637,Mobile Payment App
54,24,Non-binary,Senior,Engineering,3688,941,90,963,372,197,146,32,86,109,45,2981,707,Mobile Payment App
55,22,Female,Sophomore,Engineering,4244,1131,312,926,339,142,237,145,93,121,91,3537,707,Cash
56,24,Non-binary,Freshman,Computer Science,4824,854,700,525,223,145,133,47,91,294,191,3203,1621,Cash
57,20,Male,Sophomore,Economics,3017,1158,653,960,216,193,299,40,61,263,55,3898,-881,Mobile Payment App
58,25,Non-binary,Sophomore,Biology,3650,668,50,466,377,161,221,60,80,180,142,2405,1245,Mobile Payment App
59,20,Female,Junior,Biology,4694,695,970,626,304,104,200,47,71,223,93,3333,1361,Mobile Payment App
60,20,Male,Junior,Engineering,5389,1375,722,416,132,193,149,67,27,261,46,3388,2001,Mobile Payment App
61,23,Female,Junior,Engineering,5205,1084,315,721,230,76,141,86,34,187,159,3033,2172,Mobile Payment App
62,18,Female,Senior,Biology,5248,733,838,977,298,164,241,85,78,281,121,3816,1432,Cash
63,20,Non-binary,Freshman,Economics,5194,1061,989,464,370,58,77,135,34,124,40,3352,1842,Mobile Payment App
64,19,Female,Junior,Computer Science,3403,1352,13,477,144,82,190,109,84,81,56,2588,815,Mobile Payment App
65,19,Male,Freshman,Biology,5841,1092,550,916,150,143,257,90,29,262,192,3681,2160,Mobile Payment App
66,24,Male,Freshman,Economics,3830,963,367,883,260,79,139,135,64,54,81,3025,805,Mobile Payment App
67,21,Female,Junior,Engineering,4261,1204,121,488,283,111,287,115,56,230,85,2980,1281,Credit/Debit Card
68,23,Male,Senior,Engineering,5380,1184,104,940,115,185,171,58,45,111,30,2943,2437,Mobile Payment App
69,22,Male,Junior,Economics,4560,562,728,986,306,105,109,90,99,187,195,3367,1193,Mobile Payment App
70,19,Male,Freshman,Economics,4643,1218,878,451,234,169,240,105,21,238,101,3655,988,Mobile Payment App
71,21,Non-binary,Sophomore,Computer Science,5442,1235,805,745,390,150,228,96,80,104,35,3868,1574,Cash
72,23,Non-binary,Sophomore,Economics,3220,1424,367,684,328,118,91,143,88,98,159,3500,-280,Cash
73,22,Female,Freshman,Biology,4272,1176,804,861,305,97,106,103,43,185,104,3784,488,Mobile Payment App
74,25,Female,Sophomore,Engineering,3986,1334,81,873,180,186,236,23,61,88,87,3149,837,Credit/Debit Card
75,19,Female,Senior,Computer Science,5371,1442,354,733,153,166,105,29,80,86,137,3285,2086,Cash
76,22,Male,Sophomore,Computer Science,5650,983,862,648,159,128,259,124,97,96,150,3506,2144,Cash
77,24,Female,Sophomore,Computer Science,4881,914,24,564,149,55,61,129,79,180,94,2249,2632,Credit/Debit Card
78,22,Non-binary,Senior,Economics,5428,898,155,868,175,129,148,114,74,196,104,2861,2567,Cash
79,23,Non-binary,Junior,Economics,5212,1164,357,631,331,125,199,115,48,130,107,3207,2005,Cash
80,18,Female,Freshman,Biology,4636,1484,594,518,299,74,55,104,87,122,171,3508,1128,Mobile Payment App
81,19,Female,Junior,Biology,5104,1127,850,623,385,94,193,29,57,259,113,3730,1374,Mobile Payment App
82,24,Non-binary,Senior,Biology,5501,1105,671,841,235,164,109,144,100,252,198,3819,1682,Cash
83,19,Male,Freshman,Computer Science,4529,1351,156,678,186,178,75,34,95,97,140,2990,1539,Mobile Payment App
84,22,Female,Freshman,Biology,3050,930,768,490,349,54,174,80,51,278,143,3317,-267,Mobile Payment App
85,25,Non-binary,Senior,Computer Science,5683,1346,932,718,376,152,156,94,81,220,145,4220,1463,Credit/Debit Card
86,25,Non-binary,Sophomore,Computer Science,3901,1240,44,618,315,177,180,41,63,247,112,3037,864,Credit/Debit Card
87,25,Female,Junior,Computer Science,4051,727,143,840,269,119,121,132,40,173,198,2762,1289,Credit/Debit Card
88,20,Female,Junior,Economics,4707,622,959,431,234,184,264,54,84,295,162,3289,1418,Mobile Payment App
89,23,Male,Sophomore,Economics,5304,800,933,421,144,97,51,103,66,247,183,3045,2259,Credit/Debit Card
90,18,Non-binary,Junior,Psychology,5959,1199,516,778,260,82,238,74,82,149,126,3504,2455,Credit/Debit Card
91,19,Male,Senior,Economics,3526,1006,392,411,357,109,268,107,94,65,138,2947,579,Cash
92,23,Non-binary,Sophomore,Economics,4423,1295,903,791,397,144,64,59,79,187,189,4108,315,Mobile Payment App
93,18,Male,Sophomore,Economics,4236,1222,625,862,127,180,63,91,90,191,87,3538,698,Mobile Payment App
94,18,Female,Senior,Computer Science,4822,1384,800,809,237,174,85,21,72,130,185,3897,925,Credit/Debit Card
95,18,Female,Junior,Engineering,3367,1035,513,760,182,57,95,119,21,166,149,3097,270,Credit/Debit Card
96,20,Male,Freshman,Economics,5126,1395,723,551,258,130,81,102,84,234,172,3730,1396,Credit/Debit Card
97,18,Non-binary,Sophomore,Biology,5096,767,457,780,331,200,115,89,27,265,175,3206,1890,Credit/Debit Card
98,24,Female,Senior,Biology,4706,933,452,787,166,136,106,112,63,270,86,3111,1595,Cash
99,23,Male,Junior,Psychology,3471,803,796,931,293,54,146,142,58,84,104,3411,60,Mobile Payment App
100,22,Male,Sophomore,Psychology,3300,1333,231,971,295,51,219,91,94,259,161,3705,-405,Cash
101,23,Female,Senior,Psychology,5317,1115,437,818,341,136,116,115,22,56,38,3194,2123,Mobile Payment App
102,20,Female,Sophomore,Psychology,3366,920,149,636,295,143,77,120,96,137,162,2735,631,Cash
103,25,Male,Junior,Psychology,5931,780,95,759,216,99,251,20,38,192,105,2555,3376,Cash
104,21,Female,Junior,Psychology,5570,882,912,555,305,103,81,112,28,112,162,3252,2318,Mobile Payment App
105,21,Female,Senior,Computer Science,3200,959,258,464,360,153,220,26,88,144,161,2833,367,Cash
106,25,Female,Senior,Psychology,4789,748,494,447,353,164,201,60,43,99,93,2702,2087,Mobile Payment App
107,21,Male,Junior,Biology,4884,810,73,742,112,173,276,136,63,294,161,2840,2044,Mobile Payment App
108,20,Male,Sophomore,Computer Science,4992,965,322,433,175,56,71,89,74,66,59,2310,2682,Mobile Payment App
109,24,Male,Senior,Psychology,4906,784,513,863,116,110,140,116,56,264,179,3141,1765,Credit/Debit Card
110,22,Male,Sophomore,Economics,5894,970,553,680,344,156,114,120,79,53,40,3109,2785,Mobile Payment App
111,23,Non-binary,Senior,Economics,5866,1349,873,661,205,129,88,72,28,192,72,3669,2197,Credit/Debit Card
112,19,Female,Senior,Psychology,5429,760,61,831,268,84,63,26,92,278,185,2648,2781,Credit/Debit Card
113,21,Female,Freshman,Computer Science,4977,702,273,906,385,106,277,148,41,205,149,3192,1785,Cash
114,21,Male,Junior,Engineering,5309,720,675,661,284,95,153,93,21,108,81,2891,2418,Mobile Payment App
115,22,Male,Freshman,Biology,3618,1286,789,902,343,194,182,74,62,171,126,4129,-511,Mobile Payment App
116,22,Female,Sophomore,Engineering,4753,1135,261,629,335,168,97,113,60,223,44,3065,1688,Cash
117,18,Non-binary,Senior,Engineering,3108,1030,240,859,386,147,208,27,60,265,36,3258,-150,Credit/Debit Card
118,21,Female,Senior,Engineering,4579,1265,722,760,122,122,63,34,48,250,153,3539,1040,Credit/Debit Card
119,24,Female,Freshman,Psychology,5634,1175,803,444,290,170,63,25,37,275,111,3393,2241,Mobile Payment App
120,23,Female,Freshman,Psychology,5275,1083,10,640,236,153,257,62,87,188,55,2771,2504,Mobile Payment App
121,24,Non-binary,Freshman,Biology,3167,1487,940,765,202,146,183,145,23,233,120,4244,-1077,Mobile Payment App
122,25,Non-binary,Junior,Computer Science,5067,1327,196,613,278,179,187,149,38,227,162,3356,1711,Cash
123,22,Non-binary,Senior,Economics,4532,1095,165,801,253,167,243,73,33,110,66,3006,1526,Credit/Debit Card
124,23,Male,Senior,Biology,3230,1460,436,787,377,176,158,117,78,299,84,3972,-742,Mobile Payment App
125,20,Female,Freshman,Engineering,3691,1354,427,515,224,120,125,71,46,140,184,3206,485,Credit/Debit Card
126,20,Male,Sophomore,Biology,4311,836,620,584,301,160,193,91,46,143,120,3094,1217,Cash
127,22,Male,Junior,Engineering,4012,1212,529,897,400,53,120,117,88,284,119,3819,193,Credit/Debit Card
128,20,Non-binary,Senior,Engineering,3413,1483,277,554,182,138,275,72,35,160,74,3250,163,Credit/Debit Card
129,22,Non-binary,Sophomore,Computer Science,5420,998,935,516,297,96,103,129,78,251,109,3512,1908,Credit/Debit Card
130,22,Non-binary,Senior,Biology,4389,885,325,907,317,144,126,149,89,243,156,3341,1048,Credit/Debit Card
131,25,Male,Senior,Engineering,3854,726,333,738,177,195,110,92,77,117,30,2595,1259,Credit/Debit Card
132,25,Female,Junior,Psychology,4885,1037,990,481,367,130,272,56,57,150,92,3632,1253,Mobile Payment App
133,22,Female,Freshman,Engineering,3377,1456,993,733,201,94,284,123,34,59,77,4054,-677,Mobile Payment App
134,24,Male,Junior,Economics,4129,676,183,600,135,75,227,25,22,200,164,2307,1822,Mobile Payment App
135,24,Female,Senior,Psychology,5579,571,215,424,133,149,139,29,58,275,173,2166,3413,Mobile Payment App
136,23,Male,Junior,Computer Science,5944,1213,761,768,246,196,165,52,68,198,180,3847,2097,Mobile Payment App
137,24,Female,Sophomore,Psychology,5305,1112,547,498,357,170,183,92,84,138,92,3273,2032,Cash
138,18,Female,Sophomore,Economics,4834,1100,535,593,201,197,78,92,44,178,198,3216,1618,Credit/Debit Card
139,21,Male,Sophomore,Psychology,4279,526,375,747,159,183,197,67,21,88,58,2421,1858,Cash
140,22,Male,Junior,Computer Science,3172,951,202,818,158,68,95,76,63,122,47,2600,572,Mobile Payment App
141,23,Male,Sophomore,Computer Science,5696,1301,163,899,117,51,278,22,22,153,70,3076,2620,Cash
142,25,Male,Junior,Psychology,5960,1103,5,676,375,149,133,76,33,212,165,2927,3033,Mobile Payment App
143,24,Male,Senior,Computer Science,5692,1083,466,644,111,80,235,76,42,108,65,2910,2782,Cash
144,23,Female,Senior,Engineering,3057,860,47,614,235,115,117,71,72,226,94,2451,606,Cash
145,18,Male,Senior,Biology,3341,1354,882,969,348,75,126,49,93,201,116,4213,-872,Cash
146,23,Male,Senior,Biology,4768,877,847,465,221,96,52,39,73,94,141,2905,1863,Credit/Debit Card
147,21,Male,Freshman,Engineering,3046,649,577,931,224,161,200,24,80,213,135,3194,-148,Credit/Debit Card
148,24,Male,Sophomore,Computer Science,4655,897,220,799,358,125,290,80,23,156,177,3125,1530,Credit/Debit Card
149,21,Non-binary,Freshman,Psychology,3709,1147,872,581,102,188,225,98,72,273,126,3684,25,Mobile Payment App
150,23,Non-binary,Senior,Biology,5577,1367,606,916,260,78,213,145,71,223,123,4002,1575,Credit/Debit Card
151,21,Male,Freshman,Computer Science,4943,647,382,807,149,61,214,136,26,191,102,2715,2228,Cash
152,21,Female,Senior,Engineering,3360,656,725,931,329,188,95,120,92,102,59,3297,63,Credit/Debit Card
153,19,Non-binary,Junior,Economics,3194,1131,315,468,328,177,118,26,69,66,161,2859,335,Mobile Payment App
154,19,Female,Freshman,Psychology,4160,1319,803,677,159,73,229,140,38,108,175,3721,439,Cash
155,22,Female,Freshman,Economics,5010,917,856,434,128,184,277,98,29,115,61,3099,1911,Credit/Debit Card
156,19,Female,Sophomore,Biology,5309,872,206,944,232,166,153,58,64,67,167,2929,2380,Credit/Debit Card
157,20,Male,Sophomore,Economics,3388,901,115,737,295,84,297,66,80,146,100,2821,567,Mobile Payment App
158,18,Male,Junior,Engineering,5547,536,535,676,255,82,111,128,35,252,160,2770,2777,Credit/Debit Card
159,25,Female,Senior,Psychology,4087,506,931,998,251,175,80,82,82,76,152,3333,754,Mobile Payment App
160,23,Female,Junior,Economics,3748,1201,635,459,291,56,199,100,81,290,135,3447,301,Credit/Debit Card
161,25,Non-binary,Senior,Computer Science,5568,1189,48,815,159,79,66,113,68,91,94,2722,2846,Cash
162,23,Female,Junior,Economics,3890,546,387,747,282,140,53,35,38,67,75,2370,1520,Credit/Debit Card
163,19,Non-binary,Senior,Biology,3162,1181,989,559,196,137,89,46,60,249,134,3640,-478,Cash
164,18,Female,Sophomore,Economics,3953,810,292,771,340,51,98,120,88,133,58,2761,1192,Cash
165,19,Non-binary,Freshman,Engineering,4028,855,397,633,400,146,174,148,42,77,153,3025,1003,Cash
166,23,Male,Sophomore,Biology,5911,1354,17,631,385,160,112,34,32,225,173,3123,2788,Cash
167,20,Male,Freshman,Psychology,5433,1056,861,405,183,194,187,61,66,144,107,3264,2169,Cash
168,19,Male,Freshman,Economics,4981,620,215,704,243,197,285,135,83,192,36,2710,2271,Credit/Debit Card
169,24,Female,Freshman,Economics,4361,1207,339,638,201,143,241,112,29,86,139,3135,1226,Cash
170,21,Non-binary,Sophomore,Psychology,5893,621,456,960,199,124,278,115,48,193,178,3172,2721,Cash
171,25,Female,Senior,Engineering,4249,1033,64,517,104,64,259,131,66,234,63,2535,1714,Mobile Payment App
172,19,Non-binary,Freshman,Psychology,3701,722,2,450,102,82,267,38,65,129,186,2043,1658,Mobile Payment App
173,20,Male,Freshman,Psychology,3564,1304,76,847,180,92,300,90,64,113,34,3100,464,Mobile Payment App
174,21,Non-binary,Junior,Biology,3424,912,970,991,348,181,86,134,70,175,40,3907,-483,Credit/Debit Card
175,23,Male,Sophomore,Biology,4951,963,871,778,253,105,135,124,46,185,164,3624,1327,Cash
176,18,Female,Junior,Engineering,3015,1286,618,925,103,129,56,50,93,215,43,3518,-503,Mobile Payment App
177,18,Male,Freshman,Economics,4653,1104,180,683,362,185,90,79,91,91,99,2964,1689,Credit/Debit Card
178,23,Non-binary,Senior,Economics,3756,697,927,734,394,192,109,80,73,247,69,3522,234,Cash
179,21,Male,Freshman,Engineering,4254,1230,968,540,285,99,169,101,57,77,87,3613,641,Cash
180,25,Female,Junior,Engineering,3889,1345,649,919,311,133,68,149,66,69,159,3868,21,Mobile Payment App
181,20,Female,Junior,Biology,3074,1411,517,874,151,77,219,21,44,280,57,3651,-577,Mobile Payment App
182,24,Female,Freshman,Economics,5998,1355,282,617,311,79,264,35,73,254,131,3401,2597,Credit/Debit Card
183,24,Non-binary,Junior,Economics,4056,608,918,568,336,186,159,82,89,251,166,3363,693,Mobile Payment App
184,22,Female,Senior,Biology,3542,566,480,834,360,64,289,48,86,226,132,3085,457,Credit/Debit Card
185,25,Female,Junior,Economics,4548,1310,982,837,219,60,72,82,51,260,30,3903,645,Mobile Payment App
186,24,Female,Sophomore,Biology,3169,1354,52,849,335,60,199,77,45,101,195,3267,-98,Credit/Debit Card
187,23,Male,Sophomore,Economics,4645,1020,17,943,305,156,240,123,53,290,77,3224,1421,Cash
188,24,Non-binary,Senior,Engineering,4450,1394,871,416,268,133,146,22,68,172,126,3616,834,Cash
189,22,Non-binary,Sophomore,Psychology,5756,954,337,717,159,195,196,138,26,154,160,3036,2720,Credit/Debit Card
190,21,Male,Senior,Biology,3959,1448,794,624,171,172,103,59,89,206,182,3848,111,Mobile Payment App
191,21,Non-binary,Sophomore,Biology,4078,968,8,670,108,56,129,26,66,272,64,2367,1711,Credit/Debit Card
192,19,Male,Freshman,Economics,4103,1450,809,845,255,89,136,110,85,183,85,4047,56,Credit/Debit Card
193,22,Female,Freshman,Computer Science,4316,1316,938,953,153,179,229,105,66,184,151,4274,42,Credit/Debit Card
194,24,Male,Freshman,Computer Science,4075,904,955,875,310,197,201,91,83,224,186,4026,49,Cash
195,23,Female,Junior,Computer Science,5418,1488,77,545,112,193,158,21,64,257,168,3083,2335,Cash
196,20,Female,Junior,Psychology,5877,893,258,469,131,192,222,73,84,125,176,2623,3254,Cash
197,21,Male,Freshman,Biology,4464,527,851,683,390,194,185,127,65,188,168,3378,1086,Credit/Debit Card
198,24,Male,Senior,Biology,3043,804,640,927,347,167,151,114,35,206,94,3485,-442,Credit/Debit Card
199,25,Female,Junior,Engineering,5070,547,233,633,164,94,147,123,25,236,116,2318,2752,Credit/Debit Card
200,19,Non-binary,Freshman,Computer Science,4683,523,892,438,180,65,208,108,59,192,92,2757,1926,Cash
201,24,Female,Senior,Economics,5293,1040,970,701,323,97,196,93,62,170,90,3742,1551,Credit/Debit Card
202,24,Male,Freshman,Computer Science,3012,918,273,759,113,181,62,99,81,226,155,2867,145,Credit/Debit Card
203,23,Female,Junior,Biology,4132,504,775,997,237,69,199,111,58,62,195,3207,925,Credit/Debit Card
204,24,Female,Senior,Economics,3234,1203,115,858,249,157,292,132,94,278,66,3444,-210,Cash
205,20,Female,Senior,Psychology,4004,951,279,453,366,121,287,71,65,207,129,2929,1075,Mobile Payment App
206,24,Non-binary,Sophomore,Psychology,3939,857,583,587,147,126,160,117,85,98,69,2829,1110,Mobile Payment App
207,19,Male,Senior,Psychology,3191,812,539,744,108,189,296,31,81,204,87,3091,100,Cash
208,18,Male,Sophomore,Computer Science,5188,540,649,746,173,147,113,139,29,103,73,2712,2476,Credit/Debit Card
209,19,Non-binary,Junior,Psychology,3007,889,483,673,225,113,113,148,40,256,171,3111,-104,Cash
210,18,Non-binary,Freshman,Psychology,5718,992,680,533,241,84,276,65,81,141,171,3264,2454,Credit/Debit Card
211,21,Male,Junior,Biology,3712,760,869,567,291,94,86,141,97,55,165,3125,587,Mobile Payment App
212,25,Male,Sophomore,Biology,4865,1199,996,533,207,123,70,104,76,256,189,3753,1112,Credit/Debit Card
213,20,Female,Junior,Biology,4893,578,460,488,139,168,58,105,92,177,183,2448,2445,Credit/Debit Card
214,24,Female,Senior,Economics,4885,994,940,487,143,54,79,74,53,77,66,2967,1918,Cash
215,18,Non-binary,Junior,Economics,5312,552,481,937,307,77,71,21,52,127,46,2671,2641,Mobile Payment App
216,21,Male,Junior,Computer Science,5866,1444,792,607,396,189,125,76,80,59,79,3847,2019,Credit/Debit Card
217,19,Female,Junior,Psychology,3282,1203,550,654,182,108,288,147,38,92,182,3444,-162,Mobile Payment App
218,25,Female,Sophomore,Computer Science,4898,1481,50,982,157,162,159,30,76,225,99,3421,1477,Credit/Debit Card
219,25,Non-binary,Sophomore,Economics,5318,700,174,846,206,108,284,70,23,220,169,2800,2518,Credit/Debit Card
220,25,Female,Junior,Economics,5282,1087,415,503,155,186,116,31,31,108,141,2773,2509,Mobile Payment App
221,23,Male,Senior,Economics,4520,672,699,435,153,180,61,75,56,248,195,2774,1746,Mobile Payment App
222,21,Male,Sophomore,Computer Science,4307,825,882,589,181,54,89,113,55,266,34,3088,1219,Credit/Debit Card
223,24,Male,Sophomore,Computer Science,5997,1033,267,806,374,86,229,78,31,139,153,3196,2801,Cash
224,25,Non-binary,Freshman,Engineering,5306,774,250,942,324,73,271,107,77,92,80,2990,2316,Credit/Debit Card
225,23,Male,Junior,Engineering,3066,1365,744,936,265,52,121,46,85,292,128,4034,-968,Credit/Debit Card
226,25,Non-binary,Sophomore,Economics,3709,810,826,938,206,180,112,82,45,165,110,3474,235,Mobile Payment App
227,22,Male,Sophomore,Economics,5420,856,33,967,391,112,196,43,71,294,91,3054,2366,Mobile Payment App
228,21,Female,Senior,Psychology,4345,985,586,481,110,141,135,103,42,270,194,3047,1298,Credit/Debit Card
229,22,Non-binary,Junior,Biology,4599,919,369,788,119,170,58,124,34,97,64,2742,1857,Credit/Debit Card
230,18,Female,Sophomore,Biology,5152,637,130,559,340,62,226,42,72,244,197,2509,2643,Cash
231,20,Male,Freshman,Economics,3535,894,327,689,213,127,69,116,50,143,81,2709,826,Credit/Debit Card
232,22,Female,Senior,Economics,3452,874,561,504,299,111,237,113,71,104,45,2919,533,Cash
233,22,Female,Junior,Computer Science,3180,850,699,777,196,102,212,98,75,192,48,3249,-69,Credit/Debit Card
234,24,Non-binary,Junior,Engineering,5743,879,865,921,249,189,222,111,71,112,60,3679,2064,Credit/Debit Card
235,24,Female,Junior,Economics,3527,811,346,795,308,106,74,126,23,299,111,2999,528,Credit/Debit Card
236,21,Male,Sophomore,Computer Science,4079,809,768,505,186,176,217,70,81,194,193,3199,880,Cash
237,18,Non-binary,Senior,Psychology,5494,596,316,567,308,54,126,149,46,278,134,2574,2920,Credit/Debit Card
238,25,Male,Sophomore,Economics,3647,856,102,500,341,123,198,85,73,208,58,2544,1103,Mobile Payment App
239,25,Male,Senior,Computer Science,3489,886,143,676,219,61,198,99,95,178,46,2601,888,Mobile Payment App
240,24,Female,Sophomore,Psychology,5781,1205,715,428,346,190,79,37,28,57,182,3267,2514,Mobile Payment App
241,21,Non-binary,Freshman,Biology,4343,1353,444,622,341,198,152,106,44,236,60,3556,787,Cash
242,22,Male,Junior,Computer Science,4960,1268,886,917,100,53,102,98,66,228,124,3842,1118,Cash
243,23,Non-binary,Sophomore,Psychology,3873,1112,5,737,188,101,266,46,76,73,190,2794,1079,Cash
244,20,Female,Junior,Engineering,5211,1206,639,720,363,66,120,134,85,152,52,3537,1674,Cash
245,24,Male,Junior,Biology,3153,1159,465,891,226,55,95,46,58,284,41,3320,-167,Mobile Payment App
246,19,Non-binary,Sophomore,Biology,4859,1250,113,521,305,92,133,77,92,69,108,2760,2099,Mobile Payment App
247,20,Non-binary,Freshman,Computer Science,5509,1120,327,670,120,130,178,52,71,267,38,2973,2536,Mobile Payment App
248,24,Non-binary,Senior,Computer Science,4706,1277,520,538,374,183,243,80,74,246,152,3687,1019,Cash
249,19,Male,Freshman,Psychology,5284,1442,463,537,307,157,113,60,39,261,178,3557,1727,Mobile Payment App
250,24,Non-binary,Junior,Biology,4353,776,16,460,358,95,219,27,61,178,173,2363,1990,Cash
251,21,Female,Sophomore,Biology,3641,800,311,438,331,60,125,22,41,253,45,2426,1215,Mobile Payment App
252,18,Female,Junior,Computer Science,5416,1078,910,507,232,175,64,129,55,136,156,3442,1974,Credit/Debit Card
253,20,Male,Junior,Computer Science,3920,1404,747,760,237,104,122,28,82,115,75,3674,246,Mobile Payment App
254,21,Non-binary,Junior,Psychology,4255,1097,70,447,101,125,267,119,58,76,37,2397,1858,Credit/Debit Card
255,22,Non-binary,Freshman,Biology,3098,835,244,834,380,95,243,39,51,178,101,3000,98,Credit/Debit Card
256,18,Non-binary,Senior,Economics,3221,755,757,820,301,126,231,77,71,284,99,3521,-300,Credit/Debit Card
257,19,Male,Freshman,Engineering,5170,1087,133,872,133,86,177,73,63,198,167,2989,2181,Credit/Debit Card
258,23,Male,Sophomore,Computer Science,3012,931,950,636,329,187,96,141,96,246,193,3805,-793,Cash
259,20,Female,Sophomore,Psychology,4912,983,321,761,350,177,256,61,73,206,63,3251,1661,Credit/Debit Card
260,21,Non-binary,Sophomore,Engineering,4160,639,854,676,174,107,208,71,48,231,192,3200,960,Mobile Payment App
261,20,Male,Junior,Engineering,4231,527,438,961,212,60,287,57,31,80,162,2815,1416,Mobile Payment App
262,24,Male,Junior,Computer Science,4930,744,666,853,134,115,197,107,73,256,117,3262,1668,Mobile Payment App
263,21,Male,Freshman,Economics,3821,1118,367,956,287,112,267,65,92,147,149,3560,261,Mobile Payment App
264,22,Male,Senior,Engineering,3809,1276,606,970,124,97,271,96,81,110,136,3767,42,Credit/Debit Card
265,25,Female,Junior,Engineering,4771,880,863,903,291,100,292,108,55,217,164,3873,898,Cash
266,23,Male,Freshman,Engineering,4645,1424,887,854,140,145,156,35,36,50,114,3841,804,Mobile Payment App
267,22,Female,Senior,Psychology,3568,1276,500,785,338,144,298,91,64,173,98,3767,-199,Mobile Payment App
268,19,Non-binary,Junior,Computer Science,5958,697,943,824,274,200,89,56,31,268,175,3557,2401,Mobile Payment App
269,23,Non-binary,Senior,Computer Science,3665,1379,500,946,114,143,211,92,20,83,113,3601,64,Mobile Payment App
270,20,Female,Freshman,Computer Science,5400,1466,977,698,283,135,58,135,96,171,30,4049,1351,Credit/Debit Card
271,24,Male,Junior,Biology,3565,1126,649,483,259,63,53,57,43,65,40,2838,727,Cash
272,23,Non-binary,Senior,Biology,5535,1126,9,1000,206,135,84,70,95,295,120,3140,2395,Cash
273,21,Non-binary,Senior,Biology,4952,618,916,459,192,145,202,86,81,122,150,2971,1981,Cash
274,22,Non-binary,Junior,Biology,3495,785,303,407,245,64,92,47,82,94,104,2223,1272,Mobile Payment App
275,18,Non-binary,Senior,Computer Science,3535,770,554,468,171,104,93,75,22,74,191,2522,1013,Cash
276,25,Non-binary,Sophomore,Psychology,5216,1431,856,528,377,155,191,149,56,117,124,3984,1232,Credit/Debit Card
277,18,Female,Freshman,Biology,3955,1338,491,781,100,139,175,129,24,167,149,3493,462,Credit/Debit Card
278,25,Female,Sophomore,Psychology,3517,1121,794,407,363,101,170,60,30,168,101,3315,202,Mobile Payment App
279,24,Female,Freshman,Engineering,5833,1245,675,944,195,107,88,79,95,166,199,3793,2040,Credit/Debit Card
280,20,Female,Senior,Computer Science,3343,748,223,919,100,142,266,77,60,103,199,2837,506,Mobile Payment App
281,20,Female,Junior,Biology,3610,1389,477,811,152,91,234,82,33,171,96,3536,74,Credit/Debit Card
282,19,Female,Junior,Engineering,5969,1122,790,840,365,104,134,64,98,201,57,3775,2194,Credit/Debit Card
283,23,Male,Senior,Psychology,5456,1113,955,773,349,178,79,135,78,200,135,3995,1461,Cash
284,20,Female,Sophomore,Economics,5055,879,547,407,169,105,280,90,62,238,82,2859,2196,Cash
285,18,Non-binary,Freshman,Economics,4710,1489,202,921,101,187,122,130,38,246,96,3532,1178,Mobile Payment App
286,22,Female,Freshman,Biology,5866,869,85,754,379,127,214,111,64,276,37,2916,2950,Cash
287,23,Male,Junior,Psychology,5066,1381,520,624,356,65,97,55,84,106,65,3353,1713,Mobile Payment App
288,21,Non-binary,Sophomore,Biology,4012,1325,735,880,270,200,230,121,97,248,102,4208,-196,Cash
289,20,Male,Senior,Psychology,3705,581,492,448,318,114,186,129,85,215,188,2756,949,Cash
290,22,Non-binary,Senior,Engineering,4140,694,245,692,398,92,215,25,92,247,135,2835,1305,Mobile Payment App
291,24,Female,Sophomore,Economics,3389,615,563,403,200,109,63,145,79,233,64,2474,915,Mobile Payment App
292,25,Female,Sophomore,Economics,4998,1394,519,879,222,84,141,21,67,96,101,3524,1474,Credit/Debit Card
293,25,Female,Freshman,Biology,5867,800,223,828,298,94,166,127,81,229,48,2894,2973,Credit/Debit Card
294,20,Male,Senior,Psychology,3541,913,634,668,375,187,171,70,91,90,133,3332,209,Cash
295,19,Male,Sophomore,Psychology,5570,1243,882,574,106,190,73,85,97,264,94,3608,1962,Mobile Payment App
296,20,Female,Sophomore,Economics,3115,655,685,481,270,157,133,97,22,112,80,2692,423,Credit/Debit Card
297,18,Male,Freshman,Biology,4637,667,647,906,225,123,204,81,36,89,33,3011,1626,Credit/Debit Card
298,24,Non-binary,Senior,Economics,5143,1458,7,505,329,140,265,138,65,81,49,3037,2106,Credit/Debit Card
299,22,Non-binary,Sophomore,Biology,4445,925,350,529,227,51,173,132,24,58,183,2652,1793,Mobile Payment App
300,21,Non-binary,Senior,Economics,4114,1105,35,417,308,178,152,142,90,286,84,2797,1317,Credit/Debit Card
301,18,Male,Junior,Biology,5522,737,490,758,135,160,105,65,80,281,148,2959,2563,Cash
302,25,Female,Freshman,Computer Science,5525,1495,892,767,182,97,213,135,30,196,54,4061,1464,Mobile Payment App
303,20,Male,Senior,Economics,5002,1298,971,717,249,63,214,72,40,220,80,3924,1078,Mobile Payment App
304,21,Male,Sophomore,Psychology,3708,1272,784,810,364,90,119,32,67,91,146,3775,-67,Credit/Debit Card
305,19,Female,Senior,Biology,5383,511,825,917,201,152,117,147,42,244,75,3231,2152,Credit/Debit Card
306,21,Female,Sophomore,Engineering,5178,1161,566,653,381,155,213,116,45,208,139,3637,1541,Credit/Debit Card
307,21,Male,Senior,Psychology,5832,1112,943,881,292,93,288,135,82,67,102,3995,1837,Mobile Payment App
308,25,Male,Junior,Economics,5949,958,451,655,163,78,96,150,54,78,76,2759,3190,Cash
309,25,Non-binary,Junior,Engineering,4044,1176,186,615,319,93,108,46,96,184,61,2884,1160,Credit/Debit Card
310,20,Non-binary,Senior,Engineering,3325,727,451,570,253,76,98,55,49,229,96,2604,721,Cash
311,25,Non-binary,Senior,Biology,3048,1483,826,733,136,103,278,114,22,282,110,4087,-1039,Credit/Debit Card
312,24,Male,Junior,Computer Science,4884,881,97,857,340,166,147,34,32,298,115,2967,1917,Credit/Debit Card
313,21,Male,Freshman,Engineering,5766,1347,634,562,398,134,222,43,56,108,162,3666,2100,Mobile Payment App
314,22,Female,Freshman,Psychology,4477,725,132,822,150,61,192,133,89,204,133,2641,1836,Mobile Payment App
315,18,Non-binary,Sophomore,Biology,4171,1000,270,859,194,139,246,102,65,93,185,3153,1018,Credit/Debit Card
316,24,Female,Sophomore,Engineering,4126,795,580,454,226,132,114,117,72,158,133,2781,1345,Credit/Debit Card
317,18,Male,Senior,Economics,3962,869,447,416,369,112,71,44,51,160,74,2613,1349,Mobile Payment App
318,24,Female,Freshman,Biology,4823,543,177,976,295,153,86,107,36,143,118,2634,2189,Credit/Debit Card
319,25,Male,Sophomore,Economics,5561,1470,403,704,178,104,173,36,50,81,140,3339,2222,Credit/Debit Card
320,19,Female,Freshman,Economics,4441,734,838,437,185,79,53,129,21,149,120,2745,1696,Cash
321,20,Female,Freshman,Computer Science,5929,669,638,588,290,176,218,74,23,199,65,2940,2989,Mobile Payment App
322,19,Female,Junior,Psychology,4533,1336,417,809,268,131,237,96,88,289,113,3784,749,Cash
323,21,Female,Sophomore,Economics,5414,1436,435,748,274,89,220,34,79,241,118,3674,1740,Mobile Payment App
324,21,Non-binary,Freshman,Engineering,5292,1339,777,509,245,113,70,101,47,297,156,3654,1638,Mobile Payment App
325,18,Female,Freshman,Biology,4477,609,201,930,260,178,272,98,83,138,129,2898,1579,Credit/Debit Card
326,21,Non-binary,Sophomore,Economics,4582,1036,169,426,206,189,237,140,70,59,105,2637,1945,Mobile Payment App
327,25,Female,Senior,Engineering,5575,1309,840,923,257,115,263,78,20,236,39,4080,1495,Mobile Payment App
328,25,Male,Sophomore,Engineering,4388,1471,521,504,341,113,76,34,67,216,78,3421,967,Cash
329,19,Male,Freshman,Engineering,3579,658,487,705,292,172,198,20,50,209,68,2859,720,Mobile Payment App
330,19,Male,Junior,Engineering,5407,684,728,953,162,107,117,64,54,260,166,3295,2112,Mobile Payment App
331,20,Male,Sophomore,Computer Science,3358,907,468,877,152,170,63,44,47,176,158,3062,296,Credit/Debit Card
332,18,Male,Freshman,Computer Science,4827,846,671,928,256,61,114,21,77,160,133,3267,1560,Mobile Payment App
333,18,Female,Sophomore,Biology,5461,1175,963,498,218,81,182,26,60,296,143,3642,1819,Cash
334,25,Male,Freshman,Biology,5837,659,893,867,142,77,163,105,79,184,166,3335,2502,Credit/Debit Card
335,18,Non-binary,Sophomore,Economics,5185,1488,492,450,152,120,218,91,81,257,50,3399,1786,Cash
336,22,Female,Senior,Psychology,5107,1190,194,483,299,179,173,30,68,144,170,2930,2177,Cash
337,19,Female,Junior,Psychology,5288,742,543,772,125,162,123,126,51,94,113,2851,2437,Credit/Debit Card
338,23,Non-binary,Freshman,Psychology,3265,914,663,809,175,60,125,21,81,135,194,3177,88,Credit/Debit Card
339,19,Male,Freshman,Biology,3659,1485,53,651,221,198,124,141,85,293,57,3308,351,Cash
340,20,Female,Junior,Biology,4190,582,678,722,112,188,97,133,66,69,131,2778,1412,Credit/Debit Card
341,19,Non-binary,Junior,Engineering,4764,1468,415,613,115,157,121,31,88,77,56,3141,1623,Credit/Debit Card
342,25,Female,Sophomore,Computer Science,3755,1021,93,512,104,188,146,103,63,183,128,2541,1214,Cash
343,24,Male,Freshman,Computer Science,4727,760,281,822,394,88,191,50,48,160,188,2982,1745,Mobile Payment App
344,24,Non-binary,Freshman,Economics,3771,969,371,889,336,59,298,35,89,201,74,3321,450,Cash
345,23,Female,Senior,Biology,3846,990,431,594,330,89,114,54,72,82,132,2888,958,Mobile Payment App
346,23,Non-binary,Sophomore,Engineering,4240,1304,457,878,111,165,86,123,41,120,124,3409,831,Cash
347,23,Male,Sophomore,Biology,4759,805,0,409,255,101,285,49,45,89,115,2153,2606,Credit/Debit Card
348,25,Male,Senior,Engineering,4058,1179,223,952,340,118,65,121,51,174,41,3264,794,Credit/Debit Card
349,18,Non-binary,Senior,Computer Science,3003,573,299,878,229,131,157,58,88,53,182,2648,355,Mobile Payment App
350,25,Female,Senior,Psychology,4906,843,4,869,226,196,66,82,98,289,58,2731,2175,Mobile Payment App
351,23,Non-binary,Junior,Biology,3056,1085,795,501,170,136,155,70,46,192,89,3239,-183,Mobile Payment App
352,23,Female,Freshman,Biology,3789,580,771,707,322,170,244,114,75,79,188,3250,539,Credit/Debit Card
353,25,Female,Sophomore,Computer Science,4785,975,630,693,316,177,263,121,62,233,149,3619,1166,Cash
354,23,Male,Senior,Psychology,4542,602,608,830,378,83,229,131,54,166,145,3226,1316,Credit/Debit Card
355,23,Non-binary,Senior,Economics,4761,1103,873,671,394,121,215,112,47,118,119,3773,988,Cash
356,20,Non-binary,Freshman,Psychology,3909,816,233,949,136,165,53,59,30,275,183,2899,1010,Mobile Payment App
357,24,Male,Freshman,Engineering,5042,1016,201,606,142,54,188,106,64,162,40,2579,2463,Cash
358,23,Non-binary,Junior,Engineering,3449,969,327,516,312,182,186,25,44,186,117,2864,585,Cash
359,21,Non-binary,Junior,Computer Science,5934,918,831,949,391,81,127,121,64,275,141,3898,2036,Credit/Debit Card
360,23,Non-binary,Senior,Computer Science,4397,982,207,710,159,118,89,109,87,225,65,2751,1646,Mobile Payment App
361,25,Male,Junior,Computer Science,5979,1021,912,785,293,86,228,32,46,135,102,3640,2339,Cash
362,22,Female,Sophomore,Psychology,5701,521,884,916,342,175,221,86,46,57,112,3360,2341,Mobile Payment App
363,24,Female,Freshman,Computer Science,3721,1444,881,458,269,70,89,72,50,182,81,3596,125,Mobile Payment App
364,21,Male,Sophomore,Psychology,4218,646,487,822,124,74,108,52,97,68,105,2583,1635,Credit/Debit Card
365,21,Female,Freshman,Economics,3728,1296,133,464,212,184,298,72,53,198,111,3021,707,Mobile Payment App
366,18,Non-binary,Freshman,Economics,5759,1360,222,810,164,153,77,60,99,180,177,3302,2457,Mobile Payment App
367,19,Female,Senior,Biology,5407,1123,5,404,345,122,187,73,20,215,171,2665,2742,Cash
368,18,Female,Senior,Psychology,5837,1020,74,552,123,138,267,98,63,267,163,2765,3072,Mobile Payment App
369,21,Female,Freshman,Computer Science,3757,736,628,743,256,180,209,92,92,228,44,3208,549,Credit/Debit Card
370,23,Non-binary,Senior,Economics,5865,931,322,490,155,146,175,79,95,113,142,2648,3217,Cash
371,24,Male,Senior,Psychology,3807,1443,982,814,364,169,299,126,20,102,193,4512,-705,Mobile Payment App
372,22,Male,Freshman,Engineering,3483,730,374,675,230,68,212,124,72,156,118,2759,724,Cash
373,25,Non-binary,Senior,Economics,4229,561,759,781,147,88,144,55,95,114,142,2886,1343,Mobile Payment App
374,25,Female,Sophomore,Economics,5867,1212,616,728,378,65,159,92,79,289,35,3653,2214,Cash
375,25,Non-binary,Freshman,Computer Science,5824,1282,416,594,309,121,108,58,91,234,104,3317,2507,Cash
376,21,Non-binary,Freshman,Biology,5133,1438,364,617,392,127,249,37,28,154,170,3576,1557,Mobile Payment App
377,18,Female,Senior,Psychology,4901,702,531,497,237,150,298,46,62,225,123,2871,2030,Credit/Debit Card
378,20,Male,Senior,Biology,5002,1433,764,589,397,51,288,135,100,71,48,3876,1126,Credit/Debit Card
379,25,Female,Freshman,Psychology,4680,1444,542,829,207,122,260,109,37,127,43,3720,960,Cash
380,22,Female,Junior,Psychology,5803,536,484,413,326,104,86,99,69,197,167,2481,3322,Cash
381,18,Non-binary,Freshman,Engineering,3610,1260,68,637,296,86,87,50,54,230,183,2951,659,Credit/Debit Card
382,18,Non-binary,Freshman,Biology,3235,701,340,969,337,65,152,113,99,169,161,3106,129,Cash
383,18,Female,Freshman,Engineering,3419,1309,144,728,171,116,152,107,85,124,76,3012,407,Cash
384,18,Non-binary,Sophomore,Economics,4582,842,491,473,202,156,279,120,81,270,67,2981,1601,Credit/Debit Card
385,24,Male,Freshman,Computer Science,3795,617,863,837,231,152,256,41,74,221,130,3422,373,Credit/Debit Card
386,21,Non-binary,Junior,Engineering,5864,1134,490,714,370,96,199,114,82,67,190,3456,2408,Cash
387,23,Non-binary,Sophomore,Psychology,4210,992,242,495,187,114,58,132,96,154,134,2604,1606,Mobile Payment App
388,18,Non-binary,Freshman,Economics,4271,1408,572,477,320,78,150,150,81,163,46,3445,826,Mobile Payment App
389,21,Female,Senior,Biology,3234,1368,940,405,334,59,114,23,67,135,190,3635,-401,Mobile Payment App
390,22,Male,Senior,Economics,4056,716,157,789,358,186,216,78,74,175,169,2918,1138,Cash
391,22,Non-binary,Freshman,Psychology,5309,1224,581,936,264,55,188,126,47,194,79,3694,1615,Credit/Debit Card
392,19,Non-binary,Senior,Biology,4273,1349,788,421,106,160,147,39,89,235,182,3516,757,Cash
393,24,Female,Sophomore,Engineering,3146,802,552,724,213,95,135,103,70,267,54,3015,131,Cash
394,18,Female,Senior,Psychology,3600,973,318,913,375,183,178,122,94,129,66,3351,249,Cash
395,19,Female,Senior,Engineering,5945,736,660,478,342,75,279,43,49,107,94,2863,3082,Mobile Payment App
396,22,Male,Senior,Engineering,3897,571,498,648,181,56,275,86,57,287,79,2738,1159,Mobile Payment App
397,25,Female,Sophomore,Engineering,3133,833,56,615,147,90,201,81,30,148,42,2243,890,Cash
398,22,Female,Freshman,Computer Science,4116,713,382,592,329,120,269,46,53,230,57,2791,1325,Credit/Debit Card
399,20,Male,Junior,Economics,5900,1268,475,661,264,157,258,52,38,167,174,3514,2386,Cash
400,19,Non-binary,Freshman,Biology,5075,819,615,858,153,200,115,76,90,139,154,3219,1856,Mobile Payment App
401,18,Male,Senior,Economics,3788,1268,324,483,339,159,120,55,22,212,173,3155,633,Credit/Debit Card
402,18,Female,Senior,Engineering,4043,1486,705,661,178,64,276,80,69,144,115,3778,265,Mobile Payment App
403,24,Male,Freshman,Computer Science,3944,1005,536,687,262,148,200,138,53,146,194,3369,575,Cash
404,25,Female,Senior,Economics,3014,1205,837,593,183,142,112,77,59,209,145,3562,-548,Credit/Debit Card
405,24,Male,Senior,Engineering,5137,1356,858,747,109,170,153,46,40,131,85,3695,1442,Mobile Payment App
406,22,Male,Senior,Engineering,5754,817,555,716,382,135,142,21,29,188,183,3168,2586,Mobile Payment App
407,22,Male,Sophomore,Biology,4080,706,75,874,139,183,93,41,47,136,164,2458,1622,Cash
408,18,Non-binary,Junior,Economics,5853,1102,490,669,230,122,118,41,74,276,69,3191,2662,Cash
409,22,Male,Sophomore,Engineering,3980,1279,898,471,265,148,77,68,37,132,192,3567,413,Credit/Debit Card
410,18,Male,Sophomore,Economics,4232,1457,998,957,375,139,167,141,31,196,35,4496,-264,Credit/Debit Card
411,21,Female,Freshman,Psychology,4943,1306,37,569,326,100,277,91,85,246,48,3085,1858,Cash
412,25,Male,Sophomore,Engineering,4563,1309,433,495,309,152,290,84,99,256,37,3464,1099,Credit/Debit Card
413,19,Male,Freshman,Biology,4973,1482,705,433,294,144,233,149,59,167,130,3796,1177,Credit/Debit Card
414,23,Male,Sophomore,Economics,4845,1468,333,563,107,74,129,119,24,123,98,3038,1807,Mobile Payment App
415,25,Female,Sophomore,Economics,3556,869,102,544,387,161,158,48,80,163,93,2605,951,Credit/Debit Card
416,18,Male,Junior,Economics,5448,886,917,808,155,169,150,24,60,129,127,3425,2023,Mobile Payment App
417,19,Female,Freshman,Economics,4289,1443,831,511,190,152,108,88,61,178,146,3708,581,Mobile Payment App
418,23,Non-binary,Freshman,Biology,4782,766,95,880,254,174,238,50,48,158,157,2820,1962,Cash
419,22,Non-binary,Senior,Biology,4595,1403,31,761,331,179,57,97,67,273,179,3378,1217,Cash
420,24,Non-binary,Freshman,Engineering,4080,1372,803,432,386,184,50,65,83,248,89,3712,368,Credit/Debit Card
421,23,Non-binary,Freshman,Biology,5495,1428,597,816,332,127,271,100,22,93,163,3949,1546,Mobile Payment App
422,19,Male,Junior,Biology,4515,1303,60,511,387,179,244,68,100,261,35,3148,1367,Cash
423,20,Non-binary,Sophomore,Economics,5879,572,823,438,360,72,118,80,45,265,48,2821,3058,Credit/Debit Card
424,23,Non-binary,Junior,Economics,4648,558,194,865,183,60,113,128,38,265,42,2446,2202,Credit/Debit Card
425,23,Female,Junior,Engineering,5972,1049,476,663,116,162,52,110,21,202,86,2937,3035,Mobile Payment App
426,18,Female,Freshman,Computer Science,3640,923,108,409,384,117,249,76,68,152,86,2572,1068,Credit/Debit Card
427,18,Female,Freshman,Engineering,5779,621,35,558,252,109,289,82,51,98,53,2148,3631,Cash
428,21,Non-binary,Junior,Economics,5689,660,348,731,123,88,89,67,64,186,39,2395,3294,Mobile Payment App
429,21,Non-binary,Freshman,Biology,3863,528,92,899,127,184,100,21,55,195,125,2326,1537,Mobile Payment App
430,23,Female,Freshman,Psychology,3719,640,618,513,195,144,275,33,63,150,192,2823,896,Mobile Payment App
431,18,Female,Senior,Computer Science,4307,1427,573,797,224,161,136,87,59,159,87,3710,597,Mobile Payment App
432,18,Male,Sophomore,Computer Science,4577,527,405,532,133,134,292,62,50,164,33,2332,2245,Cash
433,25,Female,Freshman,Psychology,4591,1295,787,764,358,142,190,121,77,244,75,4053,538,Cash
434,23,Female,Sophomore,Economics,5149,1219,491,551,168,126,184,41,67,203,83,3133,2016,Cash
435,24,Female,Senior,Engineering,3200,959,696,593,318,188,153,150,89,285,54,3485,-285,Cash
436,18,Non-binary,Sophomore,Biology,3770,1483,995,569,328,159,103,126,92,284,193,4332,-562,Credit/Debit Card
437,19,Non-binary,Sophomore,Psychology,5700,646,986,857,309,77,88,66,98,174,126,3427,2273,Mobile Payment App
438,23,Male,Senior,Biology,5174,818,353,662,222,160,194,28,98,193,177,2905,2269,Credit/Debit Card
439,18,Male,Senior,Engineering,3398,1268,598,483,304,119,168,34,95,261,107,3437,-39,Credit/Debit Card
440,22,Non-binary,Freshman,Biology,4713,563,345,953,249,181,128,54,54,273,40,2840,1873,Mobile Payment App
441,21,Male,Freshman,Psychology,5096,1253,464,404,278,178,235,58,69,89,161,3189,1907,Credit/Debit Card
442,18,Non-binary,Sophomore,Engineering,5601,791,739,628,269,116,102,55,58,179,66,3003,2598,Cash
443,22,Non-binary,Sophomore,Psychology,3374,847,964,999,375,165,172,44,51,180,30,3827,-453,Cash
444,24,Male,Junior,Economics,5962,668,36,635,280,166,176,112,83,191,115,2462,3500,Mobile Payment App
445,24,Male,Freshman,Computer Science,3174,1022,883,832,121,137,142,54,65,93,47,3396,-222,Cash
446,20,Non-binary,Senior,Economics,3181,725,704,440,363,85,219,24,73,189,190,3012,169,Cash
447,24,Non-binary,Junior,Biology,3556,733,144,427,214,71,212,136,73,296,157,2463,1093,Credit/Debit Card
448,18,Non-binary,Freshman,Engineering,4569,684,745,884,322,140,265,20,99,201,132,3492,1077,Mobile Payment App
449,20,Male,Senior,Psychology,3326,604,494,622,216,141,54,90,98,268,56,2643,683,Mobile Payment App
450,23,Male,Sophomore,Engineering,5626,1346,83,799,120,125,292,140,47,62,35,3049,2577,Mobile Payment App
451,23,Non-binary,Junior,Biology,3907,1464,750,493,364,61,170,93,23,88,113,3619,288,Credit/Debit Card
452,18,Male,Sophomore,Psychology,5189,1258,333,537,370,195,195,84,57,126,125,3280,1909,Cash
453,22,Male,Freshman,Economics,3755,925,476,718,227,80,173,70,88,185,35,2977,778,Cash
454,18,Male,Sophomore,Computer Science,5715,927,880,748,217,146,227,97,46,220,162,3670,2045,Mobile Payment App
455,20,Non-binary,Freshman,Engineering,3784,1230,967,430,216,55,247,74,90,171,52,3532,252,Mobile Payment App
456,23,Non-binary,Freshman,Psychology,5522,1437,777,852,375,99,55,150,21,195,53,4014,1508,Credit/Debit Card
457,21,Female,Sophomore,Computer Science,3913,989,158,919,377,159,152,115,40,299,58,3266,647,Credit/Debit Card
458,19,Male,Senior,Biology,5884,910,724,422,365,164,294,146,34,258,152,3469,2415,Cash
459,18,Male,Freshman,Computer Science,3373,1323,441,701,369,60,235,44,78,276,38,3565,-192,Cash
460,20,Female,Sophomore,Engineering,4067,668,33,453,243,84,283,132,72,294,50,2312,1755,Mobile Payment App
461,25,Female,Senior,Biology,5665,1004,465,835,126,179,297,23,52,238,79,3298,2367,Credit/Debit Card
462,21,Female,Junior,Economics,3083,1415,561,967,347,114,175,100,30,166,162,4037,-954,Credit/Debit Card
463,18,Male,Freshman,Engineering,3799,948,739,812,344,111,205,139,94,249,107,3748,51,Credit/Debit Card
464,21,Non-binary,Junior,Biology,3146,1010,248,972,356,170,60,67,54,77,124,3138,8,Mobile Payment App
465,19,Female,Sophomore,Biology,3887,873,549,423,111,120,166,116,68,255,137,2818,1069,Credit/Debit Card
466,19,Female,Sophomore,Computer Science,4073,921,148,677,212,78,173,52,33,141,161,2596,1477,Cash
467,19,Female,Freshman,Engineering,4511,1459,285,619,299,145,295,96,71,95,35,3399,1112,Mobile Payment App
468,25,Male,Freshman,Biology,3980,672,213,420,362,64,290,131,53,201,102,2508,1472,Credit/Debit Card
469,23,Non-binary,Senior,Engineering,4335,1461,299,500,120,65,112,83,41,83,54,2818,1517,Mobile Payment App
470,24,Male,Senior,Psychology,4495,1492,644,468,234,76,205,58,80,159,157,3573,922,Credit/Debit Card
471,19,Male,Senior,Computer Science,5863,627,995,937,188,177,155,137,97,117,172,3602,2261,Cash
472,23,Male,Freshman,Computer Science,5819,961,87,781,393,56,155,64,86,146,63,2792,3027,Mobile Payment App
473,22,Male,Senior,Engineering,3455,954,134,664,332,183,227,36,69,180,45,2824,631,Credit/Debit Card
474,20,Non-binary,Junior,Biology,5843,1486,958,757,119,135,72,114,47,82,93,3863,1980,Mobile Payment App
475,24,Female,Freshman,Psychology,5918,1331,681,949,335,125,258,94,94,171,34,4072,1846,Mobile Payment App
476,21,Female,Senior,Computer Science,3257,551,492,930,335,59,61,41,60,59,146,2734,523,Cash
477,18,Non-binary,Senior,Biology,5868,1352,475,718,264,196,151,114,26,244,65,3605,2263,Credit/Debit Card
478,22,Female,Senior,Engineering,3820,1437,204,497,319,161,217,23,81,67,125,3131,689,Mobile Payment App
479,25,Non-binary,Sophomore,Biology,4965,1146,504,707,295,127,114,97,30,141,63,3224,1741,Mobile Payment App
480,21,Male,Freshman,Biology,3133,1341,899,850,364,183,262,129,26,188,94,4336,-1203,Credit/Debit Card
481,25,Female,Sophomore,Biology,5479,1331,227,750,155,184,88,87,72,87,157,3138,2341,Mobile Payment App
482,25,Male,Freshman,Computer Science,3900,1195,845,624,258,183,178,122,91,271,53,3820,80,Mobile Payment App
483,24,Non-binary,Sophomore,Psychology,5692,1247,269,638,158,196,190,92,88,174,100,3152,2540,Cash
484,25,Female,Senior,Biology,5418,663,798,420,389,97,282,144,84,149,123,3149,2269,Cash
485,23,Female,Senior,Engineering,4227,861,776,924,143,190,208,114,82,119,172,3589,638,Credit/Debit Card
486,23,Male,Senior,Economics,3025,568,340,620,300,92,233,75,52,296,191,2767,258,Credit/Debit Card
487,20,Female,Senior,Psychology,4626,802,254,568,179,64,265,124,51,117,158,2582,2044,Credit/Debit Card
488,24,Male,Freshman,Economics,5858,821,414,719,174,133,52,76,65,142,66,2662,3196,Cash
489,19,Female,Freshman,Computer Science,4354,1009,770,511,300,189,156,150,54,270,146,3555,799,Credit/Debit Card
490,19,Non-binary,Junior,Computer Science,3093,526,633,940,215,109,54,31,80,193,192,2973,120,Mobile Payment App
491,22,Female,Junior,Computer Science,3717,502,755,473,153,54,53,92,50,290,144,2566,1151,Mobile Payment App
492,19,Non-binary,Freshman,Biology,5703,860,550,503,203,171,117,29,31,87,82,2633,3070,Mobile Payment App
493,18,Non-binary,Junior,Economics,5141,1420,576,835,168,102,277,57,47,260,86,3828,1313,Cash
494,21,Female,Senior,Computer Science,4582,540,931,651,221,135,100,21,39,75,72,2785,1797,Mobile Payment App
495,25,Non-binary,Freshman,Psychology,4234,737,995,562,288,62,293,103,89,281,31,3441,793,Mobile Payment App
496,22,Non-binary,Freshman,Psychology,3138,503,57,843,276,177,175,37,26,258,105,2457,681,Cash
497,22,Female,Freshman,Computer Science,5357,673,972,828,279,95,298,97,21,154,34,3451,1906,Mobile Payment App
498,25,Female,Freshman,Psychology,5355,681,115,848,209,118,51,112,83,240,188,2645,2710,Cash
499,22,Male,Freshman,Computer Science,5387,1356,766,599,347,200,238,77,65,190,72,3910,1477,Mobile Payment App
500,25,Female,Sophomore,Computer Science,3394,1062,390,946,298,117,191,116,36,102,73,3331,63,Credit/Debit Card
501,18,Male,Sophomore,Economics,3413,1399,653,703,157,182,67,41,81,108,154,3545,-132,Cash
502,19,Female,Junior,Engineering,3268,1402,705,715,305,134,87,100,100,228,103,3879,-611,Cash
503,24,Non-binary,Sophomore,Engineering,5610,1184,260,490,376,168,183,102,73,183,85,3104,2506,Cash
504,21,Male,Senior,Economics,3735,743,351,746,305,51,201,55,74,284,117,2927,808,Cash
505,25,Male,Sophomore,Biology,3253,1384,490,462,286,158,240,90,24,296,191,3621,-368,Mobile Payment App
506,20,Male,Junior,Biology,4000,997,641,589,167,130,142,24,70,179,130,3069,931,Credit/Debit Card
507,24,Male,Senior,Engineering,4178,618,109,626,335,118,184,22,75,139,85,2311,1867,Credit/Debit Card
508,25,Female,Junior,Psychology,5329,1320,498,559,236,122,262,95,61,164,108,3425,1904,Cash
509,25,Male,Sophomore,Computer Science,4611,959,522,402,369,67,162,106,24,141,45,2797,1814,Cash
510,20,Non-binary,Junior,Psychology,4369,950,656,916,207,97,90,42,78,284,75,3395,974,Mobile Payment App
511,24,Non-binary,Senior,Economics,5916,1286,456,973,263,60,108,115,22,116,63,3462,2454,Credit/Debit Card
512,19,Non-binary,Freshman,Computer Science,4417,893,312,981,156,141,240,125,59,161,118,3186,1231,Cash
513,18,Female,Freshman,Psychology,4242,1126,891,624,182,100,136,86,66,243,83,3537,705,Cash
514,22,Male,Sophomore,Biology,5466,679,481,674,180,152,147,133,58,67,130,2701,2765,Mobile Payment App
515,25,Male,Freshman,Psychology,5914,803,201,859,143,173,143,142,96,170,103,2833,3081,Credit/Debit Card
516,18,Female,Senior,Biology,3692,664,115,963,213,70,230,150,74,199,167,2845,847,Credit/Debit Card
517,18,Male,Senior,Computer Science,5326,1500,777,772,298,182,173,112,66,170,41,4091,1235,Cash
518,22,Male,Junior,Psychology,5596,1005,777,865,158,56,113,102,71,249,148,3544,2052,Credit/Debit Card
519,22,Female,Sophomore,Biology,5515,883,640,751,243,168,240,138,20,102,55,3240,2275,Credit/Debit Card
520,18,Non-binary,Freshman,Biology,5183,1428,327,822,118,184,209,27,50,212,89,3466,1717,Cash
521,21,Non-binary,Sophomore,Economics,3883,906,449,713,338,126,300,86,46,55,64,3083,800,Cash
522,18,Non-binary,Freshman,Computer Science,3317,991,836,518,315,98,82,139,94,130,145,3348,-31,Cash
523,23,Female,Freshman,Engineering,5420,1246,754,504,372,107,222,104,31,163,116,3619,1801,Mobile Payment App
524,22,Female,Freshman,Biology,4229,1273,10,887,168,197,134,140,60,236,95,3200,1029,Credit/Debit Card
525,22,Male,Junior,Psychology,4706,880,184,415,105,182,266,58,68,277,176,2611,2095,Credit/Debit Card
526,24,Non-binary,Junior,Computer Science,5658,1356,328,901,369,156,284,114,76,145,119,3848,1810,Credit/Debit Card
527,23,Female,Junior,Economics,5244,916,927,411,249,157,173,69,71,255,83,3311,1933,Credit/Debit Card
528,18,Non-binary,Freshman,Economics,3940,1059,668,836,175,131,168,30,81,215,178,3541,399,Credit/Debit Card
529,24,Female,Junior,Psychology,3048,941,203,617,214,113,233,109,49,266,73,2818,230,Credit/Debit Card
530,24,Male,Senior,Psychology,4504,764,521,828,142,117,163,73,32,299,51,2990,1514,Mobile Payment App
531,25,Non-binary,Sophomore,Economics,4654,983,670,613,246,126,255,146,20,59,155,3273,1381,Cash
532,18,Non-binary,Senior,Biology,4502,1295,263,647,112,137,172,106,88,108,42,2970,1532,Mobile Payment App
533,22,Female,Sophomore,Computer Science,4856,1301,883,519,141,57,99,76,70,60,116,3322,1534,Cash
534,22,Non-binary,Junior,Biology,5246,829,369,702,146,88,286,144,37,268,85,2954,2292,Cash
535,22,Non-binary,Sophomore,Psychology,4574,1296,1,759,147,143,56,128,72,202,49,2853,1721,Credit/Debit Card
536,21,Male,Freshman,Biology,3566,1278,506,513,360,81,145,48,70,252,94,3347,219,Credit/Debit Card
537,18,Female,Senior,Biology,4782,725,148,643,169,164,59,137,76,207,189,2517,2265,Credit/Debit Card
538,20,Male,Senior,Biology,4603,525,41,889,187,85,118,24,85,75,158,2187,2416,Cash
539,25,Non-binary,Junior,Biology,3397,1006,293,583,167,74,195,22,75,77,174,2666,731,Mobile Payment App
540,20,Male,Sophomore,Biology,5328,872,661,470,220,167,249,122,47,152,51,3011,2317,Mobile Payment App
541,20,Non-binary,Senior,Engineering,5909,549,302,409,270,66,117,61,75,278,132,2259,3650,Credit/Debit Card
542,20,Non-binary,Junior,Engineering,5717,885,380,726,135,60,60,69,27,127,87,2556,3161,Cash
543,19,Female,Senior,Computer Science,4227,1197,772,695,180,91,104,106,31,177,48,3401,826,Mobile Payment App
544,25,Male,Senior,Psychology,5598,539,429,869,209,71,106,116,41,120,149,2649,2949,Cash
545,22,Male,Sophomore,Computer Science,3810,804,911,577,291,167,294,64,64,266,134,3572,238,Cash
546,25,Non-binary,Sophomore,Economics,3324,1109,289,946,359,123,272,88,27,141,107,3461,-137,Mobile Payment App
547,25,Female,Senior,Computer Science,3126,1126,771,823,374,125,215,90,77,242,112,3955,-829,Credit/Debit Card
548,22,Non-binary,Junior,Economics,5145,849,229,830,364,113,118,60,35,237,175,3010,2135,Cash
549,23,Non-binary,Sophomore,Psychology,4627,503,158,696,361,121,136,141,60,95,139,2410,2217,Credit/Debit Card
550,20,Male,Senior,Biology,3734,1293,449,913,324,149,134,103,86,288,131,3870,-136,Mobile Payment App
551,20,Male,Junior,Biology,4215,903,96,502,294,77,160,96,23,87,161,2399,1816,Credit/Debit Card
552,23,Non-binary,Junior,Psychology,5510,1149,685,503,308,171,206,144,82,109,196,3553,1957,Credit/Debit Card
553,20,Non-binary,Freshman,Biology,3639,1363,536,536,132,137,231,107,91,208,185,3526,113,Mobile Payment App
554,19,Non-binary,Junior,Engineering,4665,1056,959,593,100,157,214,113,50,286,87,3615,1050,Cash
555,18,Male,Senior,Engineering,3063,1245,80,836,397,136,89,110,29,155,59,3136,-73,Mobile Payment App
556,25,Female,Senior,Computer Science,5744,1149,387,849,301,112,162,141,74,89,107,3371,2373,Mobile Payment App
557,19,Female,Freshman,Psychology,4066,1226,798,494,350,192,159,34,52,226,136,3667,399,Cash
558,22,Non-binary,Freshman,Engineering,3983,965,387,466,205,191,116,65,61,192,96,2744,1239,Mobile Payment App
559,21,Male,Freshman,Engineering,4956,1338,889,658,179,79,151,116,30,116,191,3747,1209,Credit/Debit Card
560,20,Male,Senior,Engineering,5141,1414,811,752,186,139,170,64,46,148,31,3761,1380,Credit/Debit Card
561,24,Non-binary,Junior,Psychology,5249,1232,648,485,248,52,64,94,75,280,48,3226,2023,Mobile Payment App
562,18,Male,Freshman,Engineering,4015,528,612,477,286,87,93,29,76,292,175,2655,1360,Cash
563,22,Male,Sophomore,Computer Science,4846,1377,500,482,335,133,87,33,57,161,82,3247,1599,Credit/Debit Card
564,23,Non-binary,Freshman,Computer Science,4983,1078,857,887,248,152,211,52,24,180,106,3795,1188,Credit/Debit Card
565,20,Male,Sophomore,Computer Science,5019,766,926,898,226,60,174,86,22,188,147,3493,1526,Cash
566,22,Non-binary,Senior,Engineering,4960,1289,253,529,229,59,182,35,64,96,123,2859,2101,Credit/Debit Card
567,21,Male,Sophomore,Economics,4948,887,825,731,309,194,60,109,86,126,177,3504,1444,Cash
568,18,Male,Sophomore,Biology,3004,1040,721,919,206,81,197,48,60,159,132,3563,-559,Cash
569,21,Female,Senior,Engineering,5912,940,973,951,352,108,62,62,70,249,98,3865,2047,Credit/Debit Card
570,25,Male,Sophomore,Biology,5734,895,924,489,157,94,92,21,23,261,57,3013,2721,Mobile Payment App
571,25,Male,Sophomore,Psychology,3901,1113,378,533,201,133,156,146,61,144,81,2946,955,Credit/Debit Card
572,24,Non-binary,Freshman,Biology,5027,982,563,830,264,126,213,52,62,296,157,3545,1482,Cash
573,22,Male,Freshman,Psychology,5008,1401,392,769,331,149,280,38,33,100,150,3643,1365,Credit/Debit Card
574,18,Male,Sophomore,Psychology,5891,772,72,765,359,133,51,23,61,250,128,2614,3277,Mobile Payment App
575,20,Male,Senior,Economics,3866,912,387,487,261,199,225,115,34,184,197,3001,865,Credit/Debit Card
576,23,Female,Sophomore,Economics,5240,946,859,409,380,179,148,81,59,101,139,3301,1939,Cash
577,23,Non-binary,Junior,Biology,4874,834,858,565,127,102,216,119,93,143,144,3201,1673,Mobile Payment App
578,24,Male,Freshman,Psychology,3265,695,457,438,340,77,109,63,24,201,137,2541,724,Cash
579,20,Male,Sophomore,Biology,5517,1479,398,854,238,93,254,118,22,143,36,3635,1882,Cash
580,21,Non-binary,Sophomore,Economics,3783,994,469,415,144,172,133,41,88,284,116,2856,927,Mobile Payment App
581,25,Female,Sophomore,Biology,5071,843,555,604,126,195,193,107,53,159,49,2884,2187,Mobile Payment App
582,21,Non-binary,Junior,Biology,6000,1412,671,917,295,191,103,22,85,297,62,4055,1945,Mobile Payment App
583,22,Male,Junior,Computer Science,5354,727,238,733,325,182,155,42,81,220,199,2902,2452,Credit/Debit Card
584,25,Male,Sophomore,Computer Science,4637,622,642,862,290,200,266,21,44,229,168,3344,1293,Mobile Payment App
585,23,Female,Senior,Computer Science,3161,1392,197,954,287,101,168,55,52,180,135,3521,-360,Credit/Debit Card
586,19,Male,Sophomore,Computer Science,4924,1491,809,792,191,144,287,81,36,223,104,4158,766,Credit/Debit Card
587,22,Non-binary,Junior,Engineering,4378,1038,540,791,202,93,184,105,48,254,79,3334,1044,Mobile Payment App
588,24,Female,Junior,Biology,3269,854,501,990,249,198,247,135,27,53,98,3352,-83,Mobile Payment App
589,21,Male,Sophomore,Biology,5211,1415,688,857,254,156,275,148,54,227,119,4193,1018,Cash
590,18,Non-binary,Senior,Economics,4522,1136,434,642,144,121,219,149,80,188,54,3167,1355,Mobile Payment App
591,22,Non-binary,Senior,Computer Science,3645,971,100,979,163,134,50,85,86,267,193,3028,617,Credit/Debit Card
592,20,Non-binary,Senior,Economics,5206,1115,31,442,332,149,229,116,69,272,103,2858,2348,Mobile Payment App
593,20,Non-binary,Freshman,Biology,4777,523,279,417,256,188,156,105,77,191,137,2329,2448,Cash
594,24,Non-binary,Junior,Psychology,5620,533,815,850,203,166,220,91,34,235,39,3186,2434,Credit/Debit Card
595,19,Female,Sophomore,Psychology,3885,1129,832,691,131,147,218,38,38,292,168,3684,201,Cash
596,22,Non-binary,Senior,Economics,3099,739,883,900,281,111,108,121,29,161,137,3470,-371,Credit/Debit Card
597,18,Female,Senior,Engineering,3690,1099,423,973,287,98,270,146,100,136,128,3660,30,Mobile Payment App
598,25,Non-binary,Junior,Psychology,5414,610,148,887,256,57,209,84,76,220,184,2731,2683,Mobile Payment App
599,23,Male,Junior,Biology,5566,1305,642,844,274,120,178,28,28,179,122,3720,1846,Credit/Debit Card
600,23,Female,Freshman,Engineering,3369,1263,744,825,141,117,135,45,39,159,158,3626,-257,Cash
601,23,Female,Freshman,Engineering,3586,656,836,770,172,111,261,78,99,177,145,3305,281,Cash
602,22,Female,Junior,Economics,3855,975,406,752,249,93,122,125,56,181,103,3062,793,Credit/Debit Card
603,25,Male,Freshman,Computer Science,4957,1459,996,892,142,51,243,128,83,131,64,4189,768,Mobile Payment App
604,25,Non-binary,Junior,Biology,3265,1302,115,561,252,88,196,84,27,158,125,2908,357,Mobile Payment App
605,18,Female,Senior,Computer Science,4745,1115,709,733,262,118,197,97,79,182,32,3524,1221,Mobile Payment App
606,24,Non-binary,Freshman,Engineering,4614,816,658,498,181,103,54,67,68,288,163,2896,1718,Mobile Payment App
607,24,Non-binary,Freshman,Engineering,5658,1358,32,696,136,77,216,70,89,103,90,2867,2791,Mobile Payment App
608,20,Female,Junior,Psychology,5634,1054,87,998,266,170,191,137,100,175,94,3272,2362,Cash
609,24,Non-binary,Freshman,Engineering,4545,1372,208,669,262,76,211,138,83,291,73,3383,1162,Credit/Debit Card
610,24,Non-binary,Sophomore,Engineering,3718,1101,508,423,341,155,291,111,75,263,122,3390,328,Mobile Payment App
611,23,Male,Junior,Engineering,4662,1258,939,745,250,121,238,101,60,263,34,4009,653,Cash
612,23,Male,Freshman,Biology,4775,1399,663,612,289,169,116,148,74,239,199,3908,867,Cash
613,21,Male,Senior,Biology,5685,1469,592,505,272,56,239,23,57,161,107,3481,2204,Cash
614,23,Male,Sophomore,Engineering,4954,560,300,554,100,122,174,109,92,188,68,2267,2687,Cash
615,24,Male,Freshman,Engineering,5328,527,337,462,349,171,288,145,92,241,120,2732,2596,Credit/Debit Card
616,20,Male,Freshman,Biology,3264,1165,282,869,132,91,255,56,37,85,187,3159,105,Mobile Payment App
617,25,Male,Junior,Computer Science,4653,996,692,765,351,148,243,31,58,74,191,3549,1104,Credit/Debit Card
618,24,Male,Junior,Engineering,4001,630,528,921,377,193,87,142,60,155,51,3144,857,Cash
619,19,Male,Junior,Engineering,4638,542,205,838,332,67,237,74,80,205,116,2696,1942,Mobile Payment App
620,19,Non-binary,Freshman,Psychology,4294,648,929,696,267,104,215,79,96,286,35,3355,939,Credit/Debit Card
621,22,Non-binary,Senior,Computer Science,4625,639,699,463,338,80,265,51,80,295,103,3013,1612,Credit/Debit Card
622,18,Non-binary,Sophomore,Engineering,4464,729,665,670,378,122,191,145,94,198,169,3361,1103,Cash
623,19,Male,Junior,Computer Science,4614,1021,473,875,282,57,191,42,40,153,106,3240,1374,Mobile Payment App
624,23,Male,Senior,Economics,4968,1229,794,953,216,85,85,143,37,280,94,3916,1052,Credit/Debit Card
625,21,Male,Junior,Engineering,5365,660,207,547,194,59,112,98,23,229,168,2297,3068,Credit/Debit Card
626,21,Non-binary,Freshman,Computer Science,3103,1343,6,759,238,75,289,107,41,170,89,3117,-14,Cash
627,25,Non-binary,Junior,Computer Science,4562,833,410,525,330,50,245,112,89,132,137,2863,1699,Cash
628,22,Male,Freshman,Computer Science,5060,555,51,534,354,69,64,33,48,76,42,1826,3234,Cash
629,22,Male,Freshman,Engineering,5373,541,94,409,264,79,288,59,43,113,175,2065,3308,Credit/Debit Card
630,22,Non-binary,Senior,Economics,3962,748,296,721,389,71,108,89,93,106,186,2807,1155,Credit/Debit Card
631,21,Female,Sophomore,Engineering,4287,1477,497,851,296,53,95,134,61,143,87,3694,593,Cash
632,22,Non-binary,Senior,Biology,5655,1236,189,773,175,145,256,122,60,143,118,3217,2438,Credit/Debit Card
633,25,Male,Freshman,Biology,3801,592,657,939,137,127,280,59,75,265,70,3201,600,Cash
634,25,Female,Senior,Computer Science,4642,558,830,895,349,89,273,45,83,79,122,3323,1319,Mobile Payment App
635,23,Male,Sophomore,Engineering,4123,925,414,776,178,106,268,105,39,201,144,3156,967,Credit/Debit Card
636,18,Male,Senior,Computer Science,3780,719,498,494,312,149,111,126,73,60,57,2599,1181,Mobile Payment App
637,24,Female,Junior,Engineering,3266,981,875,852,201,167,102,118,72,124,62,3554,-288,Credit/Debit Card
638,25,Non-binary,Senior,Economics,3704,1381,882,464,269,88,257,105,47,106,135,3734,-30,Credit/Debit Card
639,18,Non-binary,Sophomore,Biology,3357,929,126,615,324,73,162,150,58,211,87,2735,622,Cash
640,24,Male,Junior,Biology,5452,1245,906,459,255,128,95,44,47,288,195,3662,1790,Mobile Payment App
641,20,Female,Junior,Economics,3798,691,340,748,152,53,262,118,91,112,163,2730,1068,Mobile Payment App
642,24,Female,Freshman,Psychology,5353,1326,499,852,129,166,183,91,85,291,54,3676,1677,Credit/Debit Card
643,18,Non-binary,Junior,Psychology,5199,1000,203,559,371,104,144,70,63,102,95,2711,2488,Credit/Debit Card
644,25,Male,Junior,Computer Science,5221,592,662,694,119,93,275,92,58,52,180,2817,2404,Credit/Debit Card
645,22,Male,Senior,Economics,3658,1227,226,951,218,199,238,73,79,112,196,3519,139,Mobile Payment App
646,20,Female,Sophomore,Engineering,5231,575,534,506,378,66,141,66,75,56,153,2550,2681,Cash
647,19,Female,Junior,Engineering,3510,1298,323,444,222,168,221,98,61,175,133,3143,367,Credit/Debit Card
648,23,Male,Sophomore,Engineering,3621,1141,482,572,121,184,108,41,55,93,126,2923,698,Cash
649,25,Male,Senior,Biology,5926,703,654,735,295,100,278,39,80,139,178,3201,2725,Credit/Debit Card
650,23,Female,Freshman,Economics,3445,929,160,418,213,83,159,87,54,55,198,2356,1089,Mobile Payment App
651,23,Non-binary,Junior,Engineering,3694,1415,970,513,148,157,297,104,42,294,154,4094,-400,Mobile Payment App
652,18,Non-binary,Senior,Engineering,5747,1359,387,995,263,193,246,32,23,152,110,3760,1987,Credit/Debit Card
653,23,Male,Freshman,Biology,5880,1162,720,630,259,117,113,127,94,126,89,3437,2443,Cash
654,18,Female,Sophomore,Biology,5655,663,304,632,176,89,215,57,61,51,56,2304,3351,Credit/Debit Card
655,18,Non-binary,Freshman,Economics,5568,1432,9,929,224,108,265,69,22,102,120,3280,2288,Credit/Debit Card
656,20,Non-binary,Freshman,Computer Science,3637,663,823,695,191,147,277,23,73,212,188,3292,345,Mobile Payment App
657,18,Non-binary,Senior,Economics,3975,1327,109,940,363,153,157,88,98,119,52,3406,569,Credit/Debit Card
658,22,Male,Senior,Psychology,5381,1045,359,610,269,71,209,49,83,291,168,3154,2227,Credit/Debit Card
659,21,Male,Junior,Computer Science,3238,619,605,793,380,89,87,135,36,209,92,3045,193,Credit/Debit Card
660,21,Non-binary,Freshman,Economics,3053,815,905,433,355,84,241,89,67,262,141,3392,-339,Cash
661,20,Non-binary,Freshman,Biology,5128,728,399,967,152,139,293,96,39,287,184,3284,1844,Cash
662,21,Male,Senior,Economics,3687,941,831,722,390,135,81,131,69,124,107,3531,156,Mobile Payment App
663,18,Male,Freshman,Psychology,3352,1176,43,838,211,60,278,121,21,108,87,2943,409,Credit/Debit Card
664,22,Non-binary,Sophomore,Computer Science,3997,1092,574,731,187,93,151,63,55,96,169,3211,786,Credit/Debit Card
665,18,Female,Sophomore,Biology,3394,1439,526,896,176,86,134,63,52,150,175,3697,-303,Mobile Payment App
666,22,Male,Senior,Economics,3461,816,616,543,350,101,90,103,24,245,44,2932,529,Credit/Debit Card
667,18,Male,Junior,Biology,4715,1413,775,457,264,71,250,127,54,152,91,3654,1061,Cash
668,24,Female,Sophomore,Biology,4596,1076,355,464,134,99,167,97,34,77,51,2554,2042,Cash
669,21,Female,Sophomore,Economics,5303,559,169,431,222,103,237,80,56,188,78,2123,3180,Credit/Debit Card
670,23,Male,Sophomore,Engineering,3881,1144,800,405,381,130,179,106,94,216,82,3537,344,Credit/Debit Card
671,20,Non-binary,Junior,Psychology,5452,1296,113,462,191,69,238,93,51,155,187,2855,2597,Credit/Debit Card
672,24,Male,Senior,Engineering,4579,958,902,425,262,156,72,137,21,282,82,3297,1282,Cash
673,25,Male,Junior,Economics,4195,775,709,680,115,182,84,128,26,106,112,2917,1278,Credit/Debit Card
674,25,Non-binary,Junior,Economics,4676,1483,519,970,145,168,270,23,39,72,106,3795,881,Mobile Payment App
675,19,Male,Junior,Biology,4540,1304,232,651,184,102,191,148,67,268,45,3192,1348,Mobile Payment App
676,24,Female,Sophomore,Biology,4726,1400,892,749,359,163,294,132,20,208,148,4365,361,Mobile Payment App
677,24,Non-binary,Freshman,Computer Science,5852,1440,869,759,271,75,187,77,66,295,196,4235,1617,Mobile Payment App
678,22,Female,Freshman,Economics,3562,1460,650,771,311,62,265,53,96,112,37,3817,-255,Credit/Debit Card
679,20,Non-binary,Junior,Biology,4758,1379,714,927,192,119,288,137,59,95,194,4104,654,Credit/Debit Card
680,18,Female,Junior,Computer Science,5805,942,545,914,108,50,206,24,56,54,188,3087,2718,Mobile Payment App
681,25,Non-binary,Junior,Biology,4194,740,871,473,366,83,156,62,33,86,81,2951,1243,Cash
682,18,Female,Sophomore,Psychology,5923,1186,733,541,291,111,114,42,49,73,166,3306,2617,Cash
683,23,Male,Junior,Biology,5637,731,812,582,148,74,234,27,68,158,81,2915,2722,Cash
684,20,Male,Junior,Economics,5563,1347,735,974,310,98,167,35,43,298,182,4189,1374,Cash
685,19,Female,Freshman,Biology,4680,1085,417,705,159,182,295,132,66,105,185,3331,1349,Cash
686,22,Male,Senior,Biology,3645,665,401,967,151,50,232,118,75,182,181,3022,623,Mobile Payment App
687,22,Male,Freshman,Economics,5030,1422,674,663,332,148,251,130,61,187,124,3992,1038,Cash
688,24,Male,Freshman,Biology,3549,1366,319,921,389,127,146,44,93,224,151,3780,-231,Mobile Payment App
689,21,Female,Sophomore,Engineering,3751,714,645,853,149,66,184,35,21,219,176,3062,689,Mobile Payment App
690,25,Male,Freshman,Psychology,4943,1259,139,747,200,94,226,142,39,140,95,3081,1862,Credit/Debit Card
691,19,Female,Senior,Economics,3256,975,939,936,368,179,165,144,89,52,48,3895,-639,Mobile Payment App
692,24,Female,Senior,Engineering,3609,1420,235,841,151,190,175,20,97,57,154,3340,269,Cash
693,24,Non-binary,Sophomore,Engineering,3687,604,751,554,217,66,188,122,32,169,69,2772,915,Cash
694,25,Non-binary,Senior,Economics,4288,1250,509,679,125,98,92,120,39,109,146,3167,1121,Cash
695,20,Non-binary,Freshman,Computer Science,3748,567,906,842,375,96,144,112,47,278,173,3540,208,Mobile Payment App
696,25,Female,Freshman,Computer Science,5457,546,691,978,286,100,237,60,58,206,158,3320,2137,Cash
697,18,Non-binary,Senior,Economics,5537,1169,836,996,334,83,288,78,56,105,166,4111,1426,Mobile Payment App
698,23,Non-binary,Freshman,Economics,3582,834,607,692,350,88,298,150,90,248,51,3408,174,Credit/Debit Card
699,19,Non-binary,Sophomore,Computer Science,3366,1117,234,940,212,87,121,139,41,298,119,3308,58,Mobile Payment App
700,25,Male,Freshman,Economics,5595,677,894,841,313,52,219,66,42,92,120,3316,2279,Mobile Payment App
701,20,Non-binary,Freshman,Engineering,4777,1433,964,904,327,77,112,146,71,97,167,4298,479,Cash
702,20,Female,Freshman,Biology,3100,889,633,524,247,82,201,102,92,103,96,2969,131,Credit/Debit Card
703,21,Male,Junior,Biology,5934,670,708,649,386,146,182,132,48,175,59,3155,2779,Credit/Debit Card
704,19,Male,Senior,Economics,4694,645,616,904,158,69,148,60,98,114,40,2852,1842,Credit/Debit Card
705,21,Female,Junior,Psychology,5997,1107,971,720,289,124,210,35,51,157,101,3765,2232,Mobile Payment App
706,22,Female,Sophomore,Psychology,4144,750,572,563,104,191,58,22,97,53,41,2451,1693,Cash
707,21,Male,Sophomore,Biology,3359,654,261,802,124,56,57,41,56,111,62,2224,1135,Mobile Payment App
708,20,Male,Freshman,Psychology,5734,1141,57,696,284,83,204,63,46,56,125,2755,2979,Cash
709,22,Female,Sophomore,Biology,4724,811,815,815,300,120,126,22,93,104,119,3325,1399,Cash
710,23,Female,Senior,Engineering,3463,1452,520,822,317,77,148,91,61,166,133,3787,-324,Mobile Payment App
711,20,Non-binary,Junior,Psychology,4739,1255,82,465,400,68,190,24,70,246,132,2932,1807,Mobile Payment App
712,24,Female,Junior,Computer Science,4964,737,266,780,303,111,199,62,94,193,97,2842,2122,Credit/Debit Card
713,25,Male,Freshman,Engineering,4089,1419,253,444,220,148,114,65,29,136,34,2862,1227,Credit/Debit Card
714,23,Non-binary,Freshman,Computer Science,4461,815,76,446,132,165,165,58,99,135,174,2265,2196,Cash
715,25,Male,Senior,Engineering,3444,1034,602,517,238,110,255,86,77,281,150,3350,94,Credit/Debit Card
716,24,Non-binary,Freshman,Computer Science,4797,1022,626,413,139,167,165,75,57,219,126,3009,1788,Mobile Payment App
717,23,Female,Sophomore,Biology,3033,1341,839,514,300,122,137,40,61,170,65,3589,-556,Cash
718,20,Female,Senior,Engineering,5819,999,919,507,269,119,228,99,49,55,115,3359,2460,Mobile Payment App
719,21,Male,Freshman,Psychology,5467,1218,162,684,280,131,186,103,85,91,89,3029,2438,Mobile Payment App
720,24,Male,Sophomore,Economics,3512,1332,705,796,399,199,79,54,86,206,99,3955,-443,Cash
721,20,Non-binary,Freshman,Biology,4230,903,371,798,319,60,90,101,24,147,70,2883,1347,Credit/Debit Card
722,25,Non-binary,Freshman,Biology,5307,932,887,472,345,61,190,119,69,235,67,3377,1930,Mobile Payment App
723,21,Female,Junior,Biology,5961,634,330,774,334,193,105,83,46,166,200,2865,3096,Cash
724,25,Male,Senior,Biology,3130,553,268,736,140,68,150,99,33,288,51,2386,744,Credit/Debit Card
725,21,Male,Junior,Economics,5610,547,678,510,192,123,248,57,28,252,141,2776,2834,Cash
726,18,Male,Senior,Computer Science,3014,867,646,944,320,165,232,96,73,298,142,3783,-769,Cash
727,20,Male,Sophomore,Economics,3088,863,844,966,371,66,227,117,32,245,55,3786,-698,Mobile Payment App
728,25,Non-binary,Sophomore,Biology,4879,603,321,420,231,126,248,74,32,172,80,2307,2572,Mobile Payment App
729,21,Female,Junior,Computer Science,3534,1480,555,799,259,100,254,93,66,279,191,4076,-542,Credit/Debit Card
730,18,Male,Freshman,Engineering,3744,522,448,706,174,80,284,90,61,228,66,2659,1085,Mobile Payment App
731,22,Female,Junior,Biology,3318,1376,510,460,132,159,59,88,38,87,88,2997,321,Cash
732,22,Non-binary,Junior,Computer Science,5729,1195,988,455,115,117,74,129,93,154,155,3475,2254,Credit/Debit Card
733,24,Non-binary,Freshman,Psychology,3521,1223,785,821,128,50,135,96,67,182,139,3626,-105,Credit/Debit Card
734,21,Female,Junior,Computer Science,3640,613,524,834,219,57,71,89,39,241,66,2753,887,Cash
735,25,Non-binary,Sophomore,Engineering,4017,844,766,840,179,189,230,128,74,157,38,3445,572,Mobile Payment App
736,24,Female,Junior,Computer Science,4213,620,192,726,332,144,289,92,24,195,135,2749,1464,Cash
737,22,Male,Freshman,Psychology,4216,983,944,978,114,103,58,123,72,114,76,3565,651,Credit/Debit Card
738,25,Male,Sophomore,Biology,5975,996,250,520,317,121,115,47,89,241,45,2741,3234,Mobile Payment App
739,18,Male,Junior,Engineering,3075,1106,794,881,165,166,260,23,32,135,49,3611,-536,Cash
740,23,Non-binary,Senior,Engineering,4359,1032,809,987,364,176,67,74,52,56,166,3783,576,Credit/Debit Card
741,20,Female,Senior,Biology,4647,1419,991,648,261,151,78,55,31,222,135,3991,656,Credit/Debit Card
742,22,Male,Sophomore,Economics,5142,610,100,473,298,164,139,45,67,77,32,2005,3137,Cash
743,19,Female,Junior,Economics,4790,1449,599,885,109,57,293,70,90,267,164,3983,807,Cash
744,25,Male,Senior,Engineering,3467,1270,504,484,286,132,291,138,48,155,162,3470,-3,Credit/Debit Card
745,18,Non-binary,Freshman,Computer Science,5055,770,637,814,273,55,140,134,61,131,128,3143,1912,Mobile Payment App
746,25,Non-binary,Sophomore,Psychology,4595,911,929,578,338,122,165,25,87,275,176,3606,989,Credit/Debit Card
747,18,Female,Junior,Biology,5031,1303,299,701,242,183,249,103,79,107,74,3340,1691,Credit/Debit Card
748,19,Non-binary,Junior,Engineering,3603,1367,688,452,372,162,177,29,66,243,30,3586,17,Credit/Debit Card
749,25,Non-binary,Sophomore,Computer Science,3449,509,664,779,243,153,281,108,52,70,145,3004,445,Credit/Debit Card
750,22,Male,Junior,Engineering,5299,804,582,892,153,173,199,32,84,289,126,3334,1965,Cash
751,23,Female,Freshman,Computer Science,5323,1268,271,898,204,187,215,113,81,212,111,3560,1763,Credit/Debit Card
752,22,Non-binary,Junior,Engineering,3720,1492,82,823,277,186,275,141,61,167,65,3569,151,Cash
753,23,Non-binary,Senior,Biology,3827,1402,461,904,321,138,147,114,33,198,188,3906,-79,Cash
754,24,Non-binary,Junior,Psychology,4035,673,606,818,355,103,257,35,47,56,149,3099,936,Credit/Debit Card
755,22,Female,Sophomore,Biology,4894,1174,962,426,329,191,175,29,34,113,156,3589,1305,Cash
756,20,Female,Freshman,Biology,4125,635,827,969,194,196,228,81,68,120,112,3430,695,Credit/Debit Card
757,23,Male,Sophomore,Engineering,4401,792,584,631,224,100,72,73,28,98,101,2703,1698,Credit/Debit Card
758,22,Non-binary,Sophomore,Biology,3199,998,928,565,151,71,270,78,98,291,124,3574,-375,Mobile Payment App
759,21,Non-binary,Junior,Biology,5775,866,581,773,267,100,252,32,26,97,42,3036,2739,Credit/Debit Card
760,23,Non-binary,Sophomore,Biology,3714,1408,566,905,223,168,262,124,31,123,58,3868,-154,Cash
761,25,Non-binary,Freshman,Biology,3335,732,103,742,395,154,245,130,73,178,100,2852,483,Credit/Debit Card
762,18,Non-binary,Junior,Engineering,5507,1107,511,738,144,131,213,53,38,156,137,3228,2279,Cash
763,24,Female,Freshman,Engineering,4126,1165,68,859,333,196,124,109,49,185,179,3267,859,Cash
764,19,Female,Freshman,Computer Science,4432,1316,867,627,110,185,226,25,34,90,190,3670,762,Credit/Debit Card
765,21,Non-binary,Junior,Psychology,4104,1471,280,862,312,180,241,70,90,84,182,3772,332,Cash
766,18,Non-binary,Sophomore,Psychology,3744,536,557,498,375,128,185,63,97,298,45,2782,962,Cash
767,21,Male,Sophomore,Economics,4154,1045,542,937,157,164,246,25,29,99,46,3290,864,Credit/Debit Card
768,24,Non-binary,Junior,Biology,4329,609,389,934,393,68,77,33,96,235,48,2882,1447,Mobile Payment App
769,20,Male,Senior,Psychology,4975,581,964,775,106,86,84,22,68,84,39,2809,2166,Mobile Payment App
770,20,Female,Sophomore,Biology,3376,1106,212,461,130,175,231,135,37,59,197,2743,633,Credit/Debit Card
771,22,Non-binary,Freshman,Psychology,3548,1316,710,682,382,69,268,62,95,251,118,3953,-405,Credit/Debit Card
772,19,Non-binary,Senior,Computer Science,5976,574,103,605,372,82,296,39,42,287,153,2553,3423,Credit/Debit Card
773,19,Male,Sophomore,Biology,3779,1115,12,482,306,161,281,150,76,265,170,3018,761,Mobile Payment App
774,25,Male,Sophomore,Engineering,3653,1257,45,809,373,147,246,78,36,275,158,3424,229,Credit/Debit Card
775,23,Male,Junior,Economics,5452,1069,130,503,218,83,93,72,65,170,89,2492,2960,Cash
776,22,Non-binary,Junior,Biology,3362,757,471,719,359,69,253,145,48,159,63,3043,319,Credit/Debit Card
777,21,Non-binary,Sophomore,Psychology,3624,794,166,908,371,73,222,103,41,283,152,3113,511,Cash
778,22,Male,Freshman,Computer Science,4743,1139,845,893,356,126,255,20,65,62,195,3956,787,Credit/Debit Card
779,23,Non-binary,Sophomore,Engineering,5824,598,125,413,278,130,91,88,60,152,82,2017,3807,Cash
780,21,Female,Freshman,Economics,4642,514,402,494,395,92,56,104,66,98,131,2352,2290,Mobile Payment App
781,23,Male,Freshman,Psychology,3501,1479,418,960,344,103,239,63,95,146,31,3878,-377,Mobile Payment App
782,24,Non-binary,Junior,Biology,4634,633,361,685,252,128,268,107,74,139,190,2837,1797,Credit/Debit Card
783,25,Non-binary,Senior,Biology,4770,1437,150,941,286,104,274,100,21,199,136,3648,1122,Credit/Debit Card
784,22,Male,Sophomore,Biology,4825,1135,279,793,370,115,87,93,36,102,111,3121,1704,Credit/Debit Card
785,21,Female,Junior,Engineering,4125,1433,11,832,313,123,187,134,62,61,200,3356,769,Cash
786,20,Female,Senior,Computer Science,3471,824,93,538,249,127,224,72,76,90,169,2462,1009,Credit/Debit Card
787,24,Male,Junior,Psychology,4629,967,288,958,284,107,256,129,85,172,46,3292,1337,Mobile Payment App
788,25,Male,Sophomore,Economics,3830,1126,708,405,343,159,226,98,24,197,162,3448,382,Mobile Payment App
789,21,Female,Sophomore,Psychology,5497,885,513,832,136,66,241,123,66,256,137,3255,2242,Credit/Debit Card
790,25,Non-binary,Sophomore,Psychology,4547,525,984,670,359,148,192,38,56,162,31,3165,1382,Credit/Debit Card
791,20,Male,Senior,Psychology,4309,1009,14,699,262,117,136,24,67,113,93,2534,1775,Mobile Payment App
792,18,Non-binary,Senior,Psychology,5450,1478,46,957,360,77,112,22,50,265,183,3550,1900,Mobile Payment App
793,19,Male,Sophomore,Computer Science,3465,547,365,645,316,58,186,120,54,196,135,2622,843,Mobile Payment App
794,22,Female,Freshman,Psychology,4796,549,410,749,304,167,82,142,100,271,169,2943,1853,Credit/Debit Card
795,25,Female,Junior,Engineering,5451,1326,611,734,205,91,73,95,71,217,126,3549,1902,Mobile Payment App
796,21,Male,Junior,Psychology,4836,761,9,594,375,53,256,55,41,50,126,2320,2516,Cash
797,25,Non-binary,Senior,Computer Science,5885,1344,494,809,233,167,171,83,60,94,61,3516,2369,Cash
798,22,Male,Junior,Biology,5489,895,885,456,343,157,177,123,75,77,156,3344,2145,Credit/Debit Card
799,23,Non-binary,Junior,Economics,4911,1036,811,437,398,134,299,69,55,156,35,3430,1481,Mobile Payment App
800,22,Non-binary,Senior,Computer Science,3008,664,538,417,236,75,136,131,60,243,156,2656,352,Credit/Debit Card
801,22,Non-binary,Senior,Computer Science,5886,1403,789,962,163,129,149,35,92,251,166,4139,1747,Cash
802,23,Male,Senior,Engineering,4651,1094,360,622,242,90,98,103,77,138,111,2935,1716,Cash
803,24,Female,Sophomore,Computer Science,3482,789,413,835,206,128,153,137,77,115,67,2920,562,Mobile Payment App
804,25,Non-binary,Sophomore,Biology,5035,587,756,797,291,171,283,89,26,238,74,3312,1723,Cash
805,23,Male,Junior,Biology,3729,509,395,607,326,156,251,138,45,204,30,2661,1068,Mobile Payment App
806,19,Male,Junior,Computer Science,4650,1382,935,853,203,180,230,33,55,297,43,4211,439,Credit/Debit Card
807,25,Non-binary,Senior,Engineering,3811,1301,757,664,121,115,239,126,48,121,172,3664,147,Mobile Payment App
808,23,Non-binary,Senior,Engineering,4935,777,53,505,268,181,194,79,60,71,54,2242,2693,Mobile Payment App
809,19,Male,Sophomore,Psychology,4935,505,646,688,129,143,112,130,89,209,197,2848,2087,Cash
810,24,Female,Junior,Engineering,4865,866,796,756,274,181,260,141,47,237,125,3683,1182,Cash
811,19,Male,Freshman,Biology,3321,1329,127,836,277,92,108,27,67,251,87,3201,120,Mobile Payment App
812,20,Non-binary,Freshman,Economics,4227,1372,297,505,142,144,264,20,64,195,34,3037,1190,Cash
813,24,Male,Junior,Economics,5084,1004,883,773,335,118,297,83,88,100,133,3814,1270,Credit/Debit Card
814,23,Non-binary,Freshman,Biology,4526,1415,153,880,111,167,171,90,78,205,113,3383,1143,Cash
815,20,Female,Junior,Psychology,4097,639,13,780,226,120,86,56,23,75,147,2165,1932,Mobile Payment App
816,19,Male,Sophomore,Economics,3186,1397,854,552,258,123,127,61,21,127,71,3591,-405,Credit/Debit Card
817,18,Female,Freshman,Economics,3901,935,918,724,128,122,56,39,53,152,108,3235,666,Mobile Payment App
818,18,Non-binary,Senior,Computer Science,4983,882,524,502,196,153,63,131,80,274,140,2945,2038,Credit/Debit Card
819,20,Female,Freshman,Psychology,4709,1398,912,864,267,181,165,149,62,64,92,4154,555,Mobile Payment App
820,24,Non-binary,Sophomore,Biology,3664,1461,403,519,137,127,286,115,29,84,121,3282,382,Cash
821,24,Male,Senior,Engineering,4968,1430,928,682,336,89,135,76,66,289,82,4113,855,Mobile Payment App
822,22,Non-binary,Junior,Biology,5135,953,925,924,148,56,61,33,70,156,126,3452,1683,Credit/Debit Card
823,19,Male,Junior,Psychology,3431,1456,803,636,136,177,131,112,28,249,116,3844,-413,Mobile Payment App
824,22,Female,Junior,Computer Science,5529,892,563,437,230,85,57,49,27,151,44,2535,2994,Credit/Debit Card
825,20,Non-binary,Sophomore,Psychology,4349,539,494,450,398,107,215,51,52,89,191,2586,1763,Mobile Payment App
826,25,Non-binary,Junior,Economics,4532,1024,756,798,328,112,159,69,24,275,31,3576,956,Cash
827,22,Female,Senior,Biology,5276,1405,544,782,281,52,67,69,77,270,141,3688,1588,Mobile Payment App
828,21,Male,Sophomore,Biology,3636,691,710,478,342,58,136,65,75,277,170,3002,634,Credit/Debit Card
829,19,Female,Junior,Biology,3509,1157,333,987,281,77,170,27,87,151,108,3378,131,Mobile Payment App
830,21,Non-binary,Junior,Computer Science,5657,555,980,707,302,195,207,141,91,126,180,3484,2173,Credit/Debit Card
831,25,Non-binary,Senior,Biology,4743,1245,803,899,285,99,193,106,76,270,200,4176,567,Credit/Debit Card
832,25,Male,Senior,Biology,5607,1227,408,759,365,137,247,97,56,162,136,3594,2013,Credit/Debit Card
833,18,Female,Freshman,Biology,5204,825,403,401,293,75,268,24,36,105,197,2627,2577,Mobile Payment App
834,18,Female,Freshman,Economics,3900,1359,468,401,283,190,183,60,78,153,64,3239,661,Credit/Debit Card
835,22,Male,Junior,Economics,4429,556,317,834,166,130,174,86,46,222,33,2564,1865,Mobile Payment App
836,20,Non-binary,Sophomore,Biology,5325,1110,400,586,400,62,120,54,30,294,125,3181,2144,Mobile Payment App
837,21,Non-binary,Sophomore,Engineering,4940,518,565,783,157,97,129,122,20,71,175,2637,2303,Mobile Payment App
838,19,Male,Senior,Engineering,4386,932,611,833,159,84,184,63,80,223,73,3242,1144,Mobile Payment App
839,22,Female,Senior,Computer Science,5671,683,651,866,101,155,274,131,81,183,49,3174,2497,Mobile Payment App
840,24,Male,Sophomore,Economics,5325,1397,375,637,139,83,217,55,48,293,195,3439,1886,Cash
841,24,Non-binary,Freshman,Biology,4212,1201,441,864,140,83,97,85,89,90,115,3205,1007,Credit/Debit Card
842,22,Non-binary,Junior,Psychology,3124,1402,519,886,381,193,120,64,68,153,151,3937,-813,Mobile Payment App
843,25,Male,Senior,Economics,5452,844,18,910,220,71,109,75,91,244,105,2687,2765,Credit/Debit Card
844,19,Female,Senior,Biology,5925,1366,142,614,304,163,240,127,83,108,163,3310,2615,Credit/Debit Card
845,19,Male,Senior,Biology,4576,923,734,519,383,110,255,36,31,225,126,3342,1234,Credit/Debit Card
846,21,Non-binary,Freshman,Biology,3434,542,905,987,297,160,189,150,26,286,185,3727,-293,Cash
847,23,Female,Junior,Biology,4833,1130,49,415,100,160,262,98,32,99,117,2462,2371,Credit/Debit Card
848,23,Non-binary,Junior,Biology,4663,848,420,950,173,167,101,108,29,54,159,3009,1654,Mobile Payment App
849,19,Female,Junior,Engineering,4305,1022,227,982,296,73,252,149,79,206,152,3438,867,Cash
850,23,Non-binary,Junior,Economics,4230,1189,980,607,190,52,250,140,63,190,125,3786,444,Credit/Debit Card
851,18,Female,Sophomore,Economics,3719,771,45,821,189,173,295,60,38,258,107,2757,962,Mobile Payment App
852,25,Non-binary,Sophomore,Computer Science,5743,1280,483,678,206,54,82,49,85,256,187,3360,2383,Credit/Debit Card
853,21,Male,Senior,Biology,4414,933,988,731,298,123,273,22,20,147,41,3576,838,Cash
854,24,Female,Sophomore,Computer Science,5913,1257,795,480,120,107,300,34,46,219,193,3551,2362,Mobile Payment App
855,24,Female,Junior,Computer Science,3335,1313,818,845,363,190,212,69,37,103,186,4136,-801,Cash
856,21,Male,Senior,Engineering,4084,1034,927,758,330,179,136,149,63,242,190,4008,76,Mobile Payment App
857,19,Male,Sophomore,Psychology,5509,669,153,741,335,78,170,69,68,296,73,2652,2857,Mobile Payment App
858,19,Non-binary,Senior,Computer Science,3380,728,814,970,183,178,139,29,63,193,64,3361,19,Mobile Payment App
859,18,Male,Sophomore,Economics,5429,569,513,730,375,118,195,96,27,280,65,2968,2461,Mobile Payment App
860,19,Male,Freshman,Engineering,5253,960,179,671,161,128,273,40,89,233,163,2897,2356,Cash
861,18,Male,Freshman,Computer Science,3829,1288,879,982,191,65,86,107,80,97,137,3912,-83,Cash
862,22,Female,Freshman,Engineering,3548,556,904,689,105,145,165,133,71,110,183,3061,487,Cash
863,23,Male,Senior,Engineering,5976,1413,80,836,386,194,266,29,99,213,109,3625,2351,Cash
864,25,Non-binary,Senior,Biology,4956,957,114,923,326,150,199,49,88,246,118,3170,1786,Cash
865,24,Non-binary,Freshman,Engineering,3305,1084,582,520,353,89,279,20,68,173,151,3319,-14,Mobile Payment App
866,22,Male,Freshman,Psychology,4425,1270,546,559,304,160,79,95,99,191,70,3373,1052,Mobile Payment App
867,24,Female,Sophomore,Computer Science,5594,845,484,793,130,51,153,77,47,89,151,2820,2774,Mobile Payment App
868,21,Female,Freshman,Economics,4484,1423,298,439,312,157,118,56,43,235,188,3269,1215,Cash
869,19,Male,Sophomore,Engineering,4718,683,614,643,132,186,83,31,68,85,181,2706,2012,Cash
870,21,Non-binary,Freshman,Psychology,5639,1309,561,973,303,197,117,37,64,101,37,3699,1940,Mobile Payment App
871,25,Male,Senior,Economics,4433,888,218,806,166,121,75,148,69,120,128,2739,1694,Credit/Debit Card
872,24,Male,Sophomore,Psychology,4678,1496,522,640,212,140,200,22,69,98,162,3561,1117,Credit/Debit Card
873,25,Male,Junior,Economics,4599,965,465,737,291,88,70,70,34,170,195,3085,1514,Cash
874,20,Female,Junior,Biology,3509,1329,533,826,234,131,262,142,30,157,141,3785,-276,Cash
875,21,Female,Sophomore,Engineering,5681,1021,789,844,235,99,167,115,53,127,131,3581,2100,Mobile Payment App
876,18,Male,Freshman,Biology,5257,501,422,612,149,142,72,58,36,230,73,2295,2962,Mobile Payment App
877,21,Female,Sophomore,Engineering,3930,1223,302,801,128,157,242,135,36,226,193,3443,487,Mobile Payment App
878,19,Male,Senior,Psychology,5857,1495,1000,980,228,126,82,39,72,144,78,4244,1613,Cash
879,25,Male,Sophomore,Engineering,5473,862,674,575,338,54,264,39,60,262,180,3308,2165,Cash
880,25,Male,Senior,Economics,4320,1037,844,894,393,176,280,73,21,241,44,4003,317,Credit/Debit Card
881,19,Male,Freshman,Engineering,5861,505,293,835,387,181,250,93,91,113,81,2829,3032,Cash
882,24,Female,Senior,Psychology,4234,1193,397,761,120,75,92,104,28,216,101,3087,1147,Credit/Debit Card
883,18,Non-binary,Sophomore,Psychology,3275,1452,683,586,327,65,176,32,40,205,160,3726,-451,Credit/Debit Card
884,24,Non-binary,Sophomore,Psychology,4913,1422,860,892,149,115,159,133,90,227,92,4139,774,Cash
885,25,Male,Sophomore,Biology,5618,717,197,696,354,105,102,26,95,300,110,2702,2916,Cash
886,24,Female,Junior,Economics,5187,1333,538,467,237,183,192,114,79,248,95,3486,1701,Credit/Debit Card
887,24,Female,Sophomore,Psychology,4420,978,974,642,241,146,183,30,76,130,79,3479,941,Cash
888,25,Male,Freshman,Biology,3197,1141,362,926,397,121,150,122,69,258,173,3719,-522,Mobile Payment App
889,22,Male,Sophomore,Biology,4995,1399,611,678,220,93,84,144,49,200,189,3667,1328,Mobile Payment App
890,24,Male,Freshman,Psychology,4547,1200,341,778,330,51,129,24,75,238,192,3358,1189,Cash
891,21,Non-binary,Sophomore,Economics,4305,1053,64,444,142,139,280,34,56,176,38,2426,1879,Mobile Payment App
892,25,Non-binary,Junior,Biology,4423,1118,584,592,126,149,134,74,48,109,114,3048,1375,Cash
893,21,Male,Junior,Biology,3758,1094,321,741,137,172,50,147,96,134,192,3084,674,Mobile Payment App
894,21,Non-binary,Freshman,Psychology,4206,1252,226,530,245,126,69,147,52,64,183,2894,1312,Credit/Debit Card
895,18,Male,Junior,Psychology,5848,686,252,720,238,191,265,39,58,104,142,2695,3153,Mobile Payment App
896,18,Male,Junior,Economics,5909,513,123,807,168,161,181,48,26,124,46,2197,3712,Cash
897,25,Male,Junior,Biology,4909,1174,75,799,149,163,151,138,30,298,115,3092,1817,Cash
898,24,Non-binary,Freshman,Psychology,4645,1224,235,913,209,101,77,85,97,78,80,3099,1546,Cash
899,23,Non-binary,Junior,Biology,3952,975,211,769,131,134,283,65,91,127,151,2937,1015,Credit/Debit Card
900,18,Male,Sophomore,Engineering,3626,1435,950,842,221,139,87,136,68,54,129,4061,-435,Mobile Payment App
901,22,Male,Senior,Engineering,4496,894,27,718,373,144,254,139,82,286,134,3051,1445,Credit/Debit Card
902,21,Non-binary,Junior,Economics,5292,1168,81,637,175,196,193,52,90,217,48,2857,2435,Cash
903,25,Male,Freshman,Computer Science,3987,1482,92,540,194,125,193,143,78,268,63,3178,809,Credit/Debit Card
904,19,Non-binary,Sophomore,Psychology,5745,1385,249,452,399,170,71,145,37,231,114,3253,2492,Mobile Payment App
905,20,Male,Sophomore,Computer Science,5745,1476,832,808,225,73,251,22,95,123,78,3983,1762,Mobile Payment App
906,22,Female,Senior,Economics,4840,812,101,777,195,87,51,71,48,162,188,2492,2348,Mobile Payment App
907,18,Male,Freshman,Psychology,3373,1191,611,673,327,62,164,133,26,229,107,3523,-150,Cash
908,20,Male,Senior,Economics,3823,1440,1000,525,135,142,131,34,27,90,200,3724,99,Cash
909,24,Female,Sophomore,Biology,4038,1447,246,406,235,113,98,113,50,71,37,2816,1222,Credit/Debit Card
910,21,Female,Freshman,Computer Science,4883,1030,357,806,100,99,87,46,38,155,169,2887,1996,Mobile Payment App
911,23,Female,Senior,Engineering,5347,1034,202,558,381,116,271,67,44,228,124,3025,2322,Credit/Debit Card
912,20,Female,Junior,Economics,3674,1406,10,967,303,94,286,61,61,121,181,3490,184,Mobile Payment App
913,21,Non-binary,Senior,Biology,3425,1086,38,605,381,53,171,129,24,165,136,2788,637,Credit/Debit Card
914,25,Female,Sophomore,Psychology,4772,1334,320,794,204,129,160,139,37,228,106,3451,1321,Mobile Payment App
915,25,Female,Senior,Engineering,4996,507,474,750,181,107,156,79,27,122,39,2442,2554,Cash
916,21,Male,Senior,Engineering,4014,1483,892,458,400,90,217,134,50,142,60,3926,88,Mobile Payment App
917,20,Non-binary,Sophomore,Economics,3253,888,228,539,207,182,241,71,41,254,125,2776,477,Credit/Debit Card
918,23,Non-binary,Freshman,Economics,4350,1204,815,871,166,120,275,87,77,237,85,3937,413,Credit/Debit Card
919,23,Male,Junior,Economics,5892,1047,207,667,161,197,255,53,96,168,105,2956,2936,Cash
920,21,Male,Freshman,Psychology,5478,1279,900,815,336,136,154,145,81,236,108,4190,1288,Credit/Debit Card
921,19,Female,Sophomore,Economics,5947,613,543,622,309,99,151,94,36,83,199,2749,3198,Mobile Payment App
922,18,Male,Senior,Computer Science,4843,1280,550,500,112,99,119,67,70,141,97,3035,1808,Credit/Debit Card
923,25,Male,Sophomore,Economics,5246,696,976,475,258,162,87,67,68,232,72,3093,2153,Mobile Payment App
924,20,Female,Senior,Economics,4490,1191,315,476,270,152,169,129,100,75,193,3070,1420,Credit/Debit Card
925,24,Female,Freshman,Biology,3301,1287,239,493,252,98,246,36,70,282,134,3137,164,Mobile Payment App
926,23,Female,Junior,Engineering,4261,1391,362,697,269,108,105,145,43,100,39,3259,1002,Cash
927,23,Non-binary,Sophomore,Economics,4809,1345,291,686,173,132,229,115,40,207,63,3281,1528,Credit/Debit Card
928,19,Non-binary,Junior,Computer Science,3106,1344,825,563,333,142,129,111,47,96,94,3684,-578,Cash
929,23,Non-binary,Junior,Economics,3808,779,708,876,391,94,298,34,34,192,87,3493,315,Mobile Payment App
930,23,Female,Senior,Economics,5507,1123,490,932,370,141,233,91,61,258,139,3838,1669,Mobile Payment App
931,22,Male,Senior,Economics,4766,1038,686,929,366,133,70,93,90,74,118,3597,1169,Credit/Debit Card
932,22,Female,Senior,Computer Science,3971,595,995,572,111,79,291,24,71,244,61,3043,928,Mobile Payment App
933,25,Non-binary,Freshman,Engineering,4585,1345,295,621,285,101,270,115,55,211,55,3353,1232,Cash
934,19,Non-binary,Junior,Computer Science,4102,534,546,520,371,196,106,75,56,239,45,2688,1414,Cash
935,24,Non-binary,Senior,Computer Science,4890,1176,326,837,245,93,134,78,81,54,107,3131,1759,Cash
936,20,Non-binary,Sophomore,Biology,5807,836,105,419,243,149,89,72,52,71,74,2110,3697,Mobile Payment App
937,18,Female,Freshman,Biology,4342,1047,15,620,359,195,212,63,94,193,141,2939,1403,Credit/Debit Card
938,24,Female,Sophomore,Engineering,5189,865,907,936,161,115,284,61,100,234,129,3792,1397,Mobile Payment App
939,18,Non-binary,Junior,Psychology,3353,1148,565,613,218,159,271,92,67,235,122,3490,-137,Credit/Debit Card
940,21,Female,Senior,Engineering,5238,696,715,710,195,133,98,54,66,294,41,3002,2236,Credit/Debit Card
941,19,Female,Freshman,Economics,5664,778,741,558,398,171,183,71,52,148,83,3183,2481,Credit/Debit Card
942,22,Non-binary,Senior,Psychology,5623,1140,598,665,278,183,236,110,22,238,194,3664,1959,Credit/Debit Card
943,22,Female,Sophomore,Computer Science,3510,557,351,857,112,158,269,40,78,267,31,2720,790,Cash
944,24,Male,Sophomore,Computer Science,5923,948,741,954,265,181,81,59,71,216,157,3673,2250,Mobile Payment App
945,24,Female,Freshman,Engineering,4477,1249,574,653,111,182,112,92,84,241,112,3410,1067,Mobile Payment App
946,24,Non-binary,Sophomore,Economics,4819,1092,988,768,240,158,109,111,33,236,137,3872,947,Credit/Debit Card
947,20,Female,Junior,Computer Science,5667,717,958,447,304,194,95,71,49,193,94,3122,2545,Mobile Payment App
948,19,Female,Sophomore,Computer Science,3851,857,615,487,255,95,287,31,46,299,93,3065,786,Cash
949,18,Non-binary,Senior,Biology,4690,1021,581,502,222,161,98,80,73,56,188,2982,1708,Credit/Debit Card
950,22,Female,Sophomore,Psychology,5378,1056,669,596,278,179,223,47,87,135,55,3325,2053,Mobile Payment App
951,25,Male,Freshman,Economics,4974,758,387,534,101,76,62,65,27,120,160,2290,2684,Credit/Debit Card
952,21,Non-binary,Freshman,Economics,5045,653,639,496,336,84,236,115,34,220,169,2982,2063,Cash
953,21,Male,Sophomore,Computer Science,4138,643,218,793,271,182,52,55,99,79,45,2437,1701,Credit/Debit Card
954,25,Male,Freshman,Engineering,3446,668,893,653,347,88,276,73,95,73,152,3318,128,Cash
955,25,Female,Sophomore,Psychology,3830,645,79,940,249,63,69,61,40,74,76,2296,1534,Mobile Payment App
956,20,Female,Senior,Psychology,3874,1020,522,408,150,162,168,129,98,255,138,3050,824,Credit/Debit Card
957,20,Non-binary,Junior,Computer Science,5302,1128,458,602,270,65,299,143,58,218,138,3379,1923,Cash
958,22,Male,Senior,Economics,4387,1186,650,798,139,59,160,109,21,275,119,3516,871,Mobile Payment App
959,23,Female,Senior,Psychology,4286,528,573,889,209,136,149,105,80,151,46,2866,1420,Mobile Payment App
960,25,Male,Senior,Computer Science,4397,774,799,629,163,75,183,39,33,54,136,2885,1512,Cash
961,22,Male,Senior,Economics,3954,1236,255,600,274,115,84,55,23,297,31,2970,984,Credit/Debit Card
962,24,Non-binary,Sophomore,Biology,3797,938,612,928,190,65,79,111,45,196,113,3277,520,Mobile Payment App
963,22,Non-binary,Senior,Computer Science,4110,1169,588,508,104,159,242,30,78,105,163,3146,964,Mobile Payment App
964,25,Male,Freshman,Computer Science,5826,1061,333,949,250,138,158,57,20,265,193,3424,2402,Mobile Payment App
965,24,Non-binary,Sophomore,Economics,3039,514,158,506,361,84,158,132,49,104,159,2225,814,Cash
966,19,Male,Junior,Engineering,5435,1015,493,827,369,147,121,87,49,289,121,3518,1917,Mobile Payment App
967,18,Male,Junior,Computer Science,3493,743,104,726,223,105,96,73,37,275,158,2540,953,Mobile Payment App
968,21,Male,Sophomore,Engineering,4183,913,70,714,268,88,198,87,31,69,39,2477,1706,Cash
969,24,Non-binary,Junior,Engineering,4748,1142,946,867,264,166,125,99,69,287,84,4049,699,Credit/Debit Card
970,25,Female,Senior,Psychology,3274,868,670,443,308,120,61,70,96,86,199,2921,353,Mobile Payment App
971,19,Non-binary,Sophomore,Engineering,3939,1464,17,490,357,87,131,97,67,168,87,2965,974,Credit/Debit Card
972,21,Female,Senior,Psychology,4060,1260,617,799,244,62,193,107,62,285,180,3809,251,Cash
973,19,Male,Junior,Computer Science,5451,1326,817,453,172,87,62,112,70,220,93,3412,2039,Cash
974,18,Female,Senior,Computer Science,4152,1219,671,700,335,152,296,98,86,77,82,3716,436,Cash
975,19,Non-binary,Freshman,Computer Science,5211,1038,823,576,207,92,263,54,26,270,123,3472,1739,Credit/Debit Card
976,25,Male,Junior,Biology,4350,1418,510,976,370,117,218,89,89,283,185,4255,95,Mobile Payment App
977,18,Female,Junior,Engineering,4384,1385,13,678,253,119,76,113,50,229,74,2990,1394,Mobile Payment App
978,23,Female,Freshman,Computer Science,5030,553,118,960,304,135,212,105,54,147,118,2706,2324,Mobile Payment App
979,20,Male,Senior,Economics,4119,1013,227,805,366,62,191,135,60,84,151,3094,1025,Mobile Payment App
980,18,Non-binary,Senior,Engineering,5357,1019,589,828,247,65,112,58,92,170,30,3210,2147,Mobile Payment App
981,24,Non-binary,Junior,Computer Science,4461,669,7,828,266,59,60,129,27,131,75,2251,2210,Credit/Debit Card
982,19,Female,Freshman,Computer Science,4156,933,698,780,371,80,235,84,82,269,50,3582,574,Mobile Payment App
983,20,Female,Junior,Psychology,3450,1166,671,528,164,117,238,127,56,243,84,3394,56,Cash
984,25,Non-binary,Freshman,Economics,4424,1197,652,637,248,186,186,82,58,254,116,3616,808,Mobile Payment App
985,19,Female,Senior,Biology,4709,973,695,555,114,93,190,121,70,190,129,3130,1579,Cash
986,23,Female,Junior,Computer Science,4387,1381,696,646,171,142,97,109,83,216,88,3629,758,Cash
987,22,Male,Junior,Psychology,4524,1082,221,533,276,131,242,109,21,217,49,2881,1643,Credit/Debit Card
988,23,Male,Senior,Engineering,3395,1160,168,810,105,182,51,26,64,279,74,2919,476,Cash
989,22,Female,Junior,Computer Science,3523,1011,753,475,392,187,298,99,73,125,93,3506,17,Cash
990,20,Non-binary,Senior,Psychology,5576,1412,155,443,305,119,136,120,41,290,30,3051,2525,Mobile Payment App
991,24,Non-binary,Junior,Psychology,3572,1391,259,755,136,55,86,62,66,187,153,3150,422,Cash
992,20,Male,Freshman,Economics,5635,1293,672,435,389,192,87,23,64,67,77,3299,2336,Credit/Debit Card
993,20,Male,Freshman,Psychology,3900,1380,594,739,277,187,92,144,69,283,68,3833,67,Mobile Payment App
994,22,Male,Senior,Psychology,5430,764,286,589,387,61,68,46,96,86,46,2429,3001,Mobile Payment App
995,22,Female,Senior,Biology,3750,1346,520,969,152,194,151,42,38,252,65,3729,21,Cash
996,19,Female,Senior,Biology,3500,1407,560,508,265,52,206,40,98,274,84,3494,6,Mobile Payment App
997,20,Male,Junior,Economics,3497,957,393,723,339,139,69,112,46,284,57,3119,378,Mobile Payment App
998,22,Non-binary,Senior,Economics,3649,1174,612,543,237,123,200,129,90,190,101,3399,250,Mobile Payment App
999,24,Non-binary,Sophomore,Computer Science,5965,541,640,609,270,191,215,139,43,281,88,3017,2948,Cash
